Update Date,дата,Currency Code,Funds Amount,Transaction Amount,Transaction Type,Verb,Transaction Status,Fee Currency,Fee,Balance Currency,Balance,,Payment Id,Merchant Order Id,Description,Jeton transaction ID,Account ID,Fx Rate,Original date(Created date)
07/02/2023 22:21,7,EUR,"143,25","-145,19",PAYOUT,SENT,APPROVED,EUR,"1,94",EUR,5836.18,,2115743,1403326489,Payout description,f6d462df4b8f423f9de6c4d9da6320e4,a759163a6e324c30a067be90b37241e7,,07/02/2023 22:21
07/02/2023 22:10,7,TRY,95,"3,75",PAY,RECEIVED,APPROVED,EUR,"0,65",EUR,5981.37,,15222978,7060138433,,f6cfe95426db4910b5bd6fd54236f5c5,a759163a6e324c30a067be90b37241e7,0.046,07/02/2023 22:10
07/02/2023 22:00,7,TRY,11791,"529,03",PAY,RECEIVED,APPROVED,EUR,"18,29",EUR,"5977,62","5981,37",15222912,7060099827,,f84a67b626eb43f4a4eef8dc15d93fce,a759163a6e324c30a067be90b37241e7,0.046,07/02/2023 22:00
07/02/2023 21:46,7,EUR,50,"47,87",PAY,RECEIVED,APPROVED,EUR,"2,13",EUR,5448.59,,15222745,7060033569,,b719a9fa5d0d4053b5f7ea6892901b80,a759163a6e324c30a067be90b37241e7,,07/02/2023 21:46
07/02/2023 21:36,7,PLN,25,"4,27",PAY,RECEIVED,APPROVED,EUR,"0,67",EUR,5400.72,,15222678,7059991079,,ea4d7679ee2842c7a94c5d71def3ab86,a759163a6e324c30a067be90b37241e7,0.198,07/02/2023 21:36
07/02/2023 20:56,7,TRY,50,"1,74",PAY,RECEIVED,APPROVED,EUR,"0,58",EUR,5396.45,,15222340,7059794567,,a8c0bcf6347342ffbe8d4d66dab162ae,a759163a6e324c30a067be90b37241e7,0.047,07/02/2023 20:56
07/02/2023 20:46,7,EUR,"122,03","117,56",PAY,RECEIVED,APPROVED,EUR,"4,47",EUR,5394.71,,15222240,7059737523,,55fab30987f74b2b8316847cb312b753,a759163a6e324c30a067be90b37241e7,,07/02/2023 20:46
07/02/2023 20:24,7,PLN,104,"19,4",PAY,RECEIVED,APPROVED,EUR,"1,17",EUR,5277.15,,15222042,7059613789,,66427fceb0c14e8fafb3f724576685ed,a759163a6e324c30a067be90b37241e7,0.198,07/02/2023 20:24
07/02/2023 20:21,7,EUR,"202,01","194,94",PAY,RECEIVED,APPROVED,EUR,"7,07",EUR,5257.75,,15222015,7059597735,,c1be8320908c4202beeb55d10be23fe0,a759163a6e324c30a067be90b37241e7,,07/02/2023 20:21
07/02/2023 20:06,7,EUR,"68,44","-69,63",PAYOUT,SENT,APPROVED,EUR,"1,19",EUR,5062.81,,2115260,1403140683,Payout description,76207d9bae584bbe911720e75faf1e38,a759163a6e324c30a067be90b37241e7,,07/02/2023 20:06
07/02/2023 19:57,7,TRY,579,"25,57",PAY,RECEIVED,APPROVED,EUR,"1,38",EUR,5132.44,,15221832,7059450609,,373eb12ae54546a5b9da7a54eb2d6c57,a759163a6e324c30a067be90b37241e7,0.047,07/02/2023 19:57
07/02/2023 19:06,7,EUR,355,"-359,05",PAYOUT,SENT,APPROVED,EUR,"4,05",EUR,5106.87,,2115128,1403082541,Payout description,041678a852f74c9894fbab4e96bc36d5,a759163a6e324c30a067be90b37241e7,,07/02/2023 19:06
07/02/2023 18:58,7,EUR,100,"96,25",PAY,RECEIVED,APPROVED,EUR,"3,75",EUR,5465.92,,15221236,7059047767,,77a4756b78aa4d12bbf56b8f4b179870,a759163a6e324c30a067be90b37241e7,,07/02/2023 18:58
07/02/2023 18:04,7,PLN,10,"1,4",PAY,RECEIVED,APPROVED,EUR,"0,57",EUR,5369.67,,15220705,7058699365,,6107b3f1f63e4ba9847606d8667fe3a8,a759163a6e324c30a067be90b37241e7,0.198,07/02/2023 18:04
07/02/2023 17:55,7,TRY,200,"8,47",PAY,RECEIVED,APPROVED,EUR,"0,81",EUR,5368.27,,15220616,7058635853,,f133ba070fe341b089d0679d792efc6c,a759163a6e324c30a067be90b37241e7,0.046,07/02/2023 17:55
07/02/2023 17:54,7,EUR,438,"423,26",PAY,RECEIVED,APPROVED,EUR,"14,74",EUR,5359.80,,15220589,7058620405,,b7f1312130c147e0927d90b5d47d291d,a759163a6e324c30a067be90b37241e7,,07/02/2023 17:54
07/02/2023 17:23,7,EUR,10,"9,17",PAY,RECEIVED,APPROVED,EUR,"0,83",EUR,4936.54,,15220294,7058416629,,a4449c38329b4d429e09df2a33337876,a759163a6e324c30a067be90b37241e7,,07/02/2023 17:23
07/02/2023 17:06,7,EUR,179,"-181,29",PAYOUT,SENT,APPROVED,EUR,"2,29",EUR,4927.37,,2114882,1402934141,Payout description,412a62807a22482ba3111456c93fc0e0,a759163a6e324c30a067be90b37241e7,,07/02/2023 17:06
07/02/2023 15:53,7,PLN,300,"56,79",PAY,RECEIVED,APPROVED,EUR,"2,43",EUR,5108.66,,15219542,7057825045,,a72c30692b394fba853daf8fadbd8c7f,a759163a6e324c30a067be90b37241e7,0.197,07/02/2023 15:53
07/02/2023 15:16,7,PLN,26,"4,45",PAY,RECEIVED,APPROVED,EUR,"0,67",EUR,5051.87,,15219232,7057581057,,57062af6ed82435da79ff6b4b9d733d8,a759163a6e324c30a067be90b37241e7,0.197,07/02/2023 15:16
07/02/2023 15:03,7,PLN,100,"18,55",PAY,RECEIVED,APPROVED,EUR,"1,15",EUR,5047.42,,15219111,7057493295,,cc5a4e40be7243809353231e4e68d170,a759163a6e324c30a067be90b37241e7,0.197,07/02/2023 15:03
07/02/2023 15:00,7,TRY,100,"4,01",PAY,RECEIVED,APPROVED,EUR,"0,66",EUR,5028.87,,15219071,7057466827,,e2ca15b4f0a1418d98832b484d1fbb47,a759163a6e324c30a067be90b37241e7,0.047,07/02/2023 15:00
07/02/2023 14:50,7,PLN,"6,5","0,73",PAY,RECEIVED,APPROVED,EUR,"0,55",EUR,5024.86,,15218998,7057405435,,c302a5cdfddb4f3f917d4188c0f77b96,a759163a6e324c30a067be90b37241e7,0.197,07/02/2023 14:50
07/02/2023 14:36,7,EUR,400,"-404,5",PAYOUT,SENT,APPROVED,EUR,"4,5",EUR,5024.13,,2114597,1402753869,Payout description,16fb703eda034453afa1b313e42bca1a,a759163a6e324c30a067be90b37241e7,,07/02/2023 14:36
07/02/2023 14:36,7,EUR,377,"-381,27",PAYOUT,SENT,APPROVED,EUR,"4,27",EUR,5428.63,,2114590,1402737363,Payout description,248bd7f114ed474ea18d30fd149763d4,a759163a6e324c30a067be90b37241e7,,07/02/2023 14:36
07/02/2023 14:21,7,EUR,"256,3","-259,37",PAYOUT,SENT,APPROVED,EUR,"3,07",EUR,5809.90,,2114568,1402724365,Payout description,d8f1e477dbcd4c1e8fbad1882c0e4e44,a759163a6e324c30a067be90b37241e7,,07/02/2023 14:21
07/02/2023 14:06,7,TRY,4612,"-245,72",PAYOUT,SENT,APPROVED,EUR,"2,93",EUR,6069.27,,2114539,1402709031,Payout description,499aef4d779441b788cc83f78274c559,a759163a6e324c30a067be90b37241e7,0.053,07/02/2023 14:06
07/02/2023 13:59,7,PLN,53,"9,61",PAY,RECEIVED,APPROVED,EUR,"0,84",EUR,6314.99,,15218586,7057080521,,5e68ed8a6d3c4ea287326eb4653361a6,a759163a6e324c30a067be90b37241e7,0.197,07/02/2023 13:59
07/02/2023 13:31,7,EUR,"200,8","193,77",PAY,RECEIVED,APPROVED,EUR,"7,03",EUR,6305.38,,15218353,7056895641,,57910377149c46daaab856655afd0210,a759163a6e324c30a067be90b37241e7,,07/02/2023 13:31
07/02/2023 12:55,7,TRY,100,"3,99",PAY,RECEIVED,APPROVED,EUR,"0,66",EUR,6111.61,,15218123,7056665519,,70accb29791d40f894584dc8ea365594,a759163a6e324c30a067be90b37241e7,0.047,07/02/2023 12:55
07/02/2023 12:54,7,TRY,1,"44,58",PAY,RECEIVED,APPROVED,EUR,"2,02",EUR,6107.62,,15218107,7056654529,,ad5ba6e74e534217aa185b9658046546,a759163a6e324c30a067be90b37241e7,0.047,07/02/2023 12:54
07/02/2023 12:43,7,TRY,2,"89,7",PAY,RECEIVED,APPROVED,EUR,"3,53",EUR,6063.04,,15218031,7056588529,,f3d399c3671943fd98101afd4a52390f,a759163a6e324c30a067be90b37241e7,0.047,07/02/2023 12:43
07/02/2023 12:24,7,EUR,210,"202,67",PAY,RECEIVED,APPROVED,EUR,"7,33",EUR,5973.34,,15217910,7056460167,,a4189cee3fc84aa281f32f95e17466dd,a759163a6e324c30a067be90b37241e7,,07/02/2023 12:24
07/02/2023 12:14,7,EUR,3,-3,DECREASE_BALANCE,SENT,APPROVED,EUR,0,EUR,5770.67,,15112195,6983513881,,2220ad35d9e3492daba16a5114f09ed2,a759163a6e324c30a067be90b37241e7,0.046,28/01/2023 16:21
07/02/2023 12:09,7,TRY,500,"22,03",PAY,RECEIVED,APPROVED,EUR,"1,26",EUR,8770.67,,15112119,6983444301,,f349bba29c4d45e680e770c86047fa30,a759163a6e324c30a067be90b37241e7,0.046,28/01/2023 16:14
07/02/2023 12:06,7,TRY,"603,57","-32,55",PAYOUT,SENT,APPROVED,EUR,"0,82",EUR,8748.64,,15112020,6983374837,,84a4dc64a49e4bd0972ce42d8107ace6,a759163a6e324c30a067be90b37241e7,0.046,28/01/2023 16:07
07/02/2023 11:27,7,EUR,4,"3,37",PAY,RECEIVED,APPROVED,EUR,"0,63",EUR,8781.19,,15111937,6983316767,,0d62b3c84df740a6aaf73d0ca99b4540,a759163a6e324c30a067be90b37241e7,0.199,28/01/2023 16:01
07/02/2023 11:21,7,EUR,65,"62,38",PAY,RECEIVED,APPROVED,EUR,"2,62",EUR,8777.82,,15111892,6983286233,,fa2556e9d7444fdab0e587f5efbea257,a759163a6e324c30a067be90b37241e7,,28/01/2023 15:59
07/02/2023 11:21,7,EUR,50,-51,PAYOUT,SENT,APPROVED,EUR,1,EUR,8715.44,,15111709,6983128533,,70eaeb2a5a8445c4a062b2c8a197756f,a759163a6e324c30a067be90b37241e7,0.046,28/01/2023 15:40
07/02/2023 11:18,7,EUR,100,"96,25",PAY,RECEIVED,APPROVED,EUR,"3,75",EUR,8766.44,,15111512,6982977679,,b06b2c1687a54b96b18be7db35fad3b1,a759163a6e324c30a067be90b37241e7,0.046,28/01/2023 15:24
07/02/2023 10:54,7,TRY,187,"83,71",PAY,RECEIVED,APPROVED,EUR,"3,33",EUR,8670.19,,15111461,6982941251,,16ec56c9a8584a3ea34c488e84a9b9b2,a759163a6e324c30a067be90b37241e7,,28/01/2023 15:21
07/02/2023 10:54,7,TRY,42,"188,64",PAY,RECEIVED,APPROVED,EUR,"6,86",EUR,8586.48,,2084325,1388359375,Payout description,d202d4d697f1410d8948f1e76222cdf3,a759163a6e324c30a067be90b37241e7,,28/01/2023 15:06
07/02/2023 10:38,7,PLN,200,"37,78",PAY,RECEIVED,APPROVED,EUR,"1,79",EUR,8397.84,,15111229,6982730955,,1ac7b1b765904fd59eab0914cb42d34e,a759163a6e324c30a067be90b37241e7,,28/01/2023 14:59
07/02/2023 10:36,7,EUR,15,"14,01",PAY,RECEIVED,APPROVED,EUR,"0,99",EUR,8360.06,,15111113,6982635139,,713c006288d5468a832ef0e64665a2c5,a759163a6e324c30a067be90b37241e7,,28/01/2023 14:50
07/02/2023 10:20,7,EUR,16,"14,98",PAY,RECEIVED,APPROVED,EUR,"1,02",EUR,8346.05,,2084272,1388319599,Payout description,069e85cbdeda4c64baf5811aea15e428,a759163a6e324c30a067be90b37241e7,0.052,28/01/2023 14:36
07/02/2023 10:18,7,PLN,101,"18,82",PAY,RECEIVED,APPROVED,EUR,"1,15",EUR,8331.07,,15110786,6982360053,,d49a14b85d9b4dd7b4b7e549bad60da4,a759163a6e324c30a067be90b37241e7,0.046,28/01/2023 14:21
07/02/2023 10:03,7,PLN,21,"3,51",PAY,RECEIVED,APPROVED,EUR,"0,64",EUR,8312.25,,2084243,1388313083,Payout description,2aeaf708665541609b37a447b111600c,a759163a6e324c30a067be90b37241e7,0.052,28/01/2023 14:21
07/02/2023 10:01,7,PLN,101,"18,85",PAY,RECEIVED,APPROVED,EUR,"1,15",EUR,8308.74,,15110595,6982194455,,eee7593e36664ad2bb898dbdc139ac7a,a759163a6e324c30a067be90b37241e7,0.199,28/01/2023 14:05
07/02/2023 9:46,7,PLN,50,"9,06",PAY,RECEIVED,APPROVED,EUR,"0,83",EUR,8289.89,,15110463,6982069415,,236a9db4a2674452b91fa78c4c9e85e5,a759163a6e324c30a067be90b37241e7,0.046,28/01/2023 13:52
07/02/2023 9:46,7,EUR,60,"57,55",PAY,RECEIVED,APPROVED,EUR,"2,45",EUR,8280.83,,2084156,1388260747,Payout description,cbfdb59c0e4b4968955bbfcb18ae9b73,a759163a6e324c30a067be90b37241e7,0.052,28/01/2023 13:51
07/02/2023 9:25,7,EUR,30,"28,52",PAY,RECEIVED,APPROVED,EUR,"1,48",EUR,8223.28,,15110395,6982007203,,be08ff831551405ebcf86e98156f807c,a759163a6e324c30a067be90b37241e7,,28/01/2023 13:46
07/02/2023 9:20,7,EUR,40,"38,2",PAY,RECEIVED,APPROVED,EUR,"1,8",EUR,8194.76,,2084132,1388247017,Payout description,4135881b89df4e3eb0dcf8f803e91a32,a759163a6e324c30a067be90b37241e7,0.052,28/01/2023 13:36
07/02/2023 8:56,7,EUR,15,"14,01",PAY,RECEIVED,APPROVED,EUR,"0,99",EUR,8156.56,,2084126,1388240453,Payout description,c54d75db4d904ca6b35a5bfa46a850ce,a759163a6e324c30a067be90b37241e7,0.052,28/01/2023 13:36
07/02/2023 8:53,7,PLN,51,"9,28",PAY,RECEIVED,APPROVED,EUR,"0,83",EUR,8142.55,,15110003,6981687903,,7ad40645005946f8b3986f14a2afbc0a,a759163a6e324c30a067be90b37241e7,,28/01/2023 13:19
07/02/2023 8:51,7,EUR,10,"9,17",PAY,RECEIVED,APPROVED,EUR,"0,83",EUR,8133.27,,2084054,1388213067,Payout description,c3e774f492a54479be1c362a8e5cd42b,a759163a6e324c30a067be90b37241e7,,28/01/2023 13:06
07/02/2023 8:51,7,PLN,312,"-70,97",PAYOUT,SENT,APPROVED,EUR,"1,2",EUR,8124.10,,15109875,6981579487,,f03c432ada5b4d32b32fe4df7a46602b,a759163a6e324c30a067be90b37241e7,,28/01/2023 13:01
07/02/2023 8:45,7,EUR,15,"14,01",PAY,RECEIVED,APPROVED,EUR,"0,99",EUR,8195.07,,2083963,1388179605,Payout description,b191f52f3919484687532ef53c593148,a759163a6e324c30a067be90b37241e7,0.052,28/01/2023 12:36
07/02/2023 8:26,7,PLN,10,"1,4",PAY,RECEIVED,APPROVED,EUR,"0,57",EUR,8181.06,,15109440,6981270617,,67ea754756de40c895b4d35980a6e55c,a759163a6e324c30a067be90b37241e7,0.046,28/01/2023 12:28
07/02/2023 8:15,7,PLN,101,"18,83",PAY,RECEIVED,APPROVED,EUR,"1,15",EUR,8179.66,,15109270,6981112109,,0b48298eb47240038feba71ff1200771,a759163a6e324c30a067be90b37241e7,0.046,28/01/2023 12:12
07/02/2023 8:05,7,PLN,50,"9,07",PAY,RECEIVED,APPROVED,EUR,"0,83",EUR,8160.83,,2083885,1388128803,Payout description,b29df9e3a480436b8ed2b0792ebf284c,a759163a6e324c30a067be90b37241e7,,28/01/2023 12:06
07/02/2023 7:52,7,PLN,"50,6","9,19",PAY,RECEIVED,APPROVED,EUR,"0,83",EUR,8151.76,,15108421,6980435851,,df5419fdfa134be597e145fcfbc56b86,a759163a6e324c30a067be90b37241e7,0.046,28/01/2023 10:56
07/02/2023 7:36,7,EUR,"23,2","-23,94",PAYOUT,SENT,APPROVED,EUR,"0,74",EUR,8142.57,,15108314,6980370303,,55963d25498f491eb8442ee6cff71864,a759163a6e324c30a067be90b37241e7,0.046,28/01/2023 10:48
07/02/2023 7:35,7,TRY,7,"314,25",PAY,RECEIVED,APPROVED,EUR,"11,08",EUR,8166.51,,15108170,6980279323,,5697a97b6a354ba0a691064c60c47879,a759163a6e324c30a067be90b37241e7,0.046,28/01/2023 10:37
07/02/2023 7:26,7,TRY,2,"89,4",PAY,RECEIVED,APPROVED,EUR,"3,53",EUR,7852.26,,15107955,6980146653,,5f2fc8dce2c742ccb6b08afd8ae6d50f,a759163a6e324c30a067be90b37241e7,,28/01/2023 10:20
07/02/2023 7:18,7,PLN,50,"9,07",PAY,RECEIVED,APPROVED,EUR,"0,83",EUR,7762.86,,15107847,6980080145,,394782f05ddf4277951ce91f508b6e70,a759163a6e324c30a067be90b37241e7,0.046,28/01/2023 10:12
07/02/2023 6:56,7,EUR,20,"18,85",PAY,RECEIVED,APPROVED,EUR,"1,15",EUR,7753.79,,15107743,6980002749,,f05ff54d91734db78de9957769ecb1b5,a759163a6e324c30a067be90b37241e7,,28/01/2023 10:03
07/02/2023 6:27,7,EUR,12,"11,11",PAY,RECEIVED,APPROVED,EUR,"0,89",EUR,7734.94,,2083478,1387986995,Payout description,701c01ae009a47e3926ff16766c82d58,a759163a6e324c30a067be90b37241e7,,28/01/2023 9:51
07/02/2023 0:51,7,TRY,12,"-636,14",PAYOUT,SENT,APPROVED,EUR,"6,8",EUR,7723.83,,15107396,6979774775,,8c41e421ec6e443892c56b81d7a02335,a759163a6e324c30a067be90b37241e7,,28/01/2023 9:30
07/02/2023 0:51,7,EUR,"297,92","-301,4",PAYOUT,SENT,APPROVED,EUR,"3,48",EUR,8359.97,,15107373,6979757227,,3ef49a4aa6db4e37a9717dc7d99f61ea,a759163a6e324c30a067be90b37241e7,,28/01/2023 9:28
07/02/2023 0:28,7,TRY,"10000,33","448,84",PAY,RECEIVED,APPROVED,EUR,"15,6",EUR,8661.37,,15107359,6979747091,,e8839655425941078cf2afbf37870190,a759163a6e324c30a067be90b37241e7,,28/01/2023 9:26
06/02/2023 22:21,6,EUR,40,"-40,9",PAYOUT,SENT,APPROVED,EUR,"0,9",EUR,8212.53,,15107142,6979601757,,8d5a4aaafd2045888367ffd55c6fb996,a759163a6e324c30a067be90b37241e7,,28/01/2023 9:11
06/02/2023 21:51,6,PLN,512,"-116,09",PAYOUT,SENT,APPROVED,EUR,"1,65",EUR,8253.43,,15107184,6979623885,,14874126e50e4cf9b5d90e77a948a4f2,a759163a6e324c30a067be90b37241e7,,28/01/2023 9:08
06/02/2023 21:49,6,TRY,100,"3,98",PAY,RECEIVED,APPROVED,EUR,"0,66",EUR,8369.52,,2083347,1387928019,Payout description,917049711d1a4e89821d91829e5c702f,a759163a6e324c30a067be90b37241e7,,28/01/2023 9:06
06/02/2023 21:36,6,TRY,1876,"-99,98",PAYOUT,SENT,APPROVED,EUR,"1,49",EUR,8365.54,,15107153,6979605227,,b20b087886964bcfb2264b26d00fe107,a759163a6e324c30a067be90b37241e7,,28/01/2023 9:04
06/02/2023 21:31,6,EUR,10,"9,17",PAY,RECEIVED,APPROVED,EUR,"0,83",EUR,8465.52,,15107101,6979579397,,d1093148f7814dc58d8252d25cabb827,a759163a6e324c30a067be90b37241e7,,28/01/2023 9:03
06/02/2023 21:24,6,TRY,10,"449,52",PAY,RECEIVED,APPROVED,EUR,"15,62",EUR,8456.35,,15106780,6979321101,,db19f17c1bb14292979d77ee64f105a9,a759163a6e324c30a067be90b37241e7,0.199,28/01/2023 8:17
06/02/2023 21:21,6,TRY,1056,"-560,27",PAYOUT,SENT,APPROVED,EUR,"6,05",EUR,8006.83,,15106756,6979300931,,1db7500132ce4f7198f4185974e3c152,a759163a6e324c30a067be90b37241e7,0.046,28/01/2023 8:12
06/02/2023 21:20,6,EUR,5,"4,33",PAY,RECEIVED,APPROVED,EUR,"0,67",EUR,8567.10,,15106707,6979265883,,297a43c43cd846df88e707cb91d203b1,a759163a6e324c30a067be90b37241e7,,28/01/2023 8:06
06/02/2023 19:37,6,TRY,10,"449,23",PAY,RECEIVED,APPROVED,EUR,"15,61",EUR,8562.77,,15106651,6979225709,,064509daf81f40c78a13abb2f7cc0585,a759163a6e324c30a067be90b37241e7,,28/01/2023 7:58
06/02/2023 19:21,6,EUR,"26,71","25,34",PAY,RECEIVED,APPROVED,EUR,"1,37",EUR,8113.54,,15106597,6979186501,,9eca35543dbf410b96437aa6d85703a4,a759163a6e324c30a067be90b37241e7,,28/01/2023 7:49
06/02/2023 19:21,6,TRY,1095,"-580,41",PAYOUT,SENT,APPROVED,EUR,"6,25",EUR,8088.20,,15106459,6979073749,,681780367875405cbd52290e4045de27,a759163a6e324c30a067be90b37241e7,,28/01/2023 7:24
06/02/2023 19:08,6,PLN,10,"1,4",PAY,RECEIVED,APPROVED,EUR,"0,57",EUR,8668.61,,15106387,6979011731,,571f7af2053649a2a672811d4552a747,a759163a6e324c30a067be90b37241e7,0.046,28/01/2023 7:08
06/02/2023 19:07,6,EUR,"79,52","76,43",PAY,RECEIVED,APPROVED,EUR,"3,09",EUR,8667.21,,15106376,6979002785,,c601e680dbc74c55b6b23a3407e20369,a759163a6e324c30a067be90b37241e7,,28/01/2023 7:06
06/02/2023 19:03,6,TRY,500,"21,99",PAY,RECEIVED,APPROVED,EUR,"1,26",EUR,8590.78,,15106362,6978992653,,c890ce0b408d46408bcd16bb03d76fb0,a759163a6e324c30a067be90b37241e7,,28/01/2023 7:04
06/02/2023 18:21,6,TRY,500,"-27,04",PAYOUT,SENT,APPROVED,EUR,"0,77",EUR,8568.79,,15106253,6978930693,,2bd9e5e1c10148328b7b7b85ea39083a,a759163a6e324c30a067be90b37241e7,0.011,28/01/2023 6:48
06/02/2023 18:21,6,TRY,3268,"-173,87",PAYOUT,SENT,APPROVED,EUR,"2,22",EUR,8595.83,,15106034,6978770373,,e0fa1321d748486f88acb040c4c89b28,a759163a6e324c30a067be90b37241e7,,28/01/2023 5:56
06/02/2023 17:58,6,TRY,10,"450,12",PAY,RECEIVED,APPROVED,EUR,"15,64",EUR,8769.70,,15105900,6978671125,,d523a5b46e3142bf9a6980b680e6b62d,a759163a6e324c30a067be90b37241e7,,28/01/2023 5:18
06/02/2023 17:57,6,PLN,51,"9,26",PAY,RECEIVED,APPROVED,EUR,"0,83",EUR,8319.58,,15105639,6978480535,,7f897476a2ee47d0b7acad952d73751b,a759163a6e324c30a067be90b37241e7,0.199,28/01/2023 3:47
06/02/2023 17:53,6,EUR,183,"176,55",PAY,RECEIVED,APPROVED,EUR,"6,45",EUR,8310.32,,15105623,6978469351,,42576404fabf48f48e81a7dc8abbd99c,a759163a6e324c30a067be90b37241e7,0.199,28/01/2023 3:41
06/02/2023 17:48,6,PLN,51,"9,26",PAY,RECEIVED,APPROVED,EUR,"0,83",EUR,8133.77,,15105587,6978448289,,f9da21d3d7164ee9b70881738d5f8ef3,a759163a6e324c30a067be90b37241e7,0.199,28/01/2023 3:30
06/02/2023 17:36,6,TRY,1144,"-607,63",PAYOUT,SENT,APPROVED,EUR,"6,52",EUR,8124.51,,15105363,6978314323,,1d8587f0a6274f8a9c46ab3c20f8ce39,a759163a6e324c30a067be90b37241e7,0.084,28/01/2023 2:13
06/02/2023 17:21,6,EUR,55,"-56,05",PAYOUT,SENT,APPROVED,EUR,"1,05",EUR,8732.14,,2082863,1387641659,Payout description,edf3f4bb3c83446cabfee75f443cee81,a759163a6e324c30a067be90b37241e7,0.052,28/01/2023 2:06
06/02/2023 16:51,6,EUR,168,"-170,18",PAYOUT,SENT,APPROVED,EUR,"2,18",EUR,8788.19,,15105136,6978202029,,2d83864909944bd0aedf0b92eff60e4d,a759163a6e324c30a067be90b37241e7,0.046,28/01/2023 1:14
06/02/2023 16:36,6,PLN,100,"18,66",PAY,RECEIVED,APPROVED,EUR,"1,15",EUR,8958.37,,15105015,6978149367,,902d3f67e567472592055ab51ad9001f,a759163a6e324c30a067be90b37241e7,0.046,28/01/2023 0:53
06/02/2023 16:19,6,EUR,"52,01","49,81",PAY,RECEIVED,APPROVED,EUR,"2,2",EUR,8939.71,,15104841,6978065415,,7d2572f5371f4ca3a1cf9a12e232fa7d,a759163a6e324c30a067be90b37241e7,0.199,28/01/2023 0:22
06/02/2023 16:01,6,TRY,10,"449,39",PAY,RECEIVED,APPROVED,EUR,"15,62",EUR,8889.90,,15104819,6978054979,,12845098a386418abeaf441a9948f4ba,a759163a6e324c30a067be90b37241e7,0.199,28/01/2023 0:19
06/02/2023 15:56,6,PLN,"51,4","9,34",PAY,RECEIVED,APPROVED,EUR,"0,84",EUR,8440.51,,2082705,1387568419,Payout description,5b46c083dd6c4b60ae13171afb564911,a759163a6e324c30a067be90b37241e7,0.052,27/01/2023 23:51
06/02/2023 15:52,6,PLN,40,"7,16",PAY,RECEIVED,APPROVED,EUR,"0,76",EUR,8431.17,,15104597,6977947577,,9431190f93d646aa8ae7c3f5eff53629,a759163a6e324c30a067be90b37241e7,0.046,27/01/2023 23:45
06/02/2023 15:51,6,TRY,10,"-530,7",PAYOUT,SENT,APPROVED,EUR,"5,75",EUR,8424.01,,15104551,6977926097,,a4d3daed3ac840cabd06cc27fa5c1705,a759163a6e324c30a067be90b37241e7,0.046,27/01/2023 23:40
06/02/2023 15:46,6,PLN,10,"1,41",PAY,RECEIVED,APPROVED,EUR,"0,57",EUR,8954.71,,2082525,1387513203,Payout description,8770e0f024c2442f8b9b65c02489563b,a759163a6e324c30a067be90b37241e7,0.052,27/01/2023 22:51
06/02/2023 15:34,6,EUR,50,"47,87",PAY,RECEIVED,APPROVED,EUR,"2,13",EUR,8953.30,,2082421,1387482315,Payout description,3fdf0821da2d41089618bda2ae8a2cbd,a759163a6e324c30a067be90b37241e7,0.052,27/01/2023 22:21
06/02/2023 15:06,6,TRY,1,"-53,42",PAYOUT,SENT,APPROVED,EUR,"1,03",EUR,8905.43,,15103596,6977467723,,6efec235a23746509f715c3998c1f919,a759163a6e324c30a067be90b37241e7,,27/01/2023 21:57
06/02/2023 15:06,6,TRY,1,"-53,42",PAYOUT,SENT,APPROVED,EUR,"1,03",EUR,8958.85,,15103525,6977440363,,6d2d71cea3a3429d9128f944051f58f7,a759163a6e324c30a067be90b37241e7,,27/01/2023 21:52
06/02/2023 14:49,6,EUR,"15,31","14,31",PAY,RECEIVED,APPROVED,EUR,1,EUR,9012.27,,2082255,1387411623,Payout description,101fe6c1d43f4131b9e53ec8893ad810,a759163a6e324c30a067be90b37241e7,0.052,27/01/2023 21:51
06/02/2023 14:29,6,EUR,"30,65","29,15",PAY,RECEIVED,APPROVED,EUR,"1,5",EUR,8997.96,,15103494,6977423479,,f6992f10789143c08e231a6d58b12c79,a759163a6e324c30a067be90b37241e7,0.046,27/01/2023 21:48
06/02/2023 14:13,6,EUR,"61,1","58,61",PAY,RECEIVED,APPROVED,EUR,"2,49",EUR,8968.81,,15103399,6977379291,,ebe63b7f2dc041a699bd2611322087e8,a759163a6e324c30a067be90b37241e7,,27/01/2023 21:40
06/02/2023 14:06,6,EUR,10,"9,17",PAY,RECEIVED,APPROVED,EUR,"0,83",EUR,8910.20,,15103390,6977376043,,fb8f148c8fb04e82a3b9597099b7f77d,a759163a6e324c30a067be90b37241e7,0.046,27/01/2023 21:38
06/02/2023 13:46,6,EUR,67,"64,32",PAY,RECEIVED,APPROVED,EUR,"2,68",EUR,8901.03,,15103284,6977320383,,6df3c5c5c82c46f3888ecc124dfe776f,a759163a6e324c30a067be90b37241e7,0.046,27/01/2023 21:28
06/02/2023 12:55,6,EUR,50,"47,87",PAY,RECEIVED,APPROVED,EUR,"2,13",EUR,8836.71,,15103244,6977305473,,35d111de3bb94a4a87dd6846b239f612,a759163a6e324c30a067be90b37241e7,,27/01/2023 21:26
06/02/2023 12:51,6,TRY,900,"-47,96",PAYOUT,SENT,APPROVED,EUR,"0,97",EUR,8788.84,,15102788,6977041137,,d4bf123da28f4eb49b93f8cf25ee96de,a759163a6e324c30a067be90b37241e7,0.046,27/01/2023 20:42
06/02/2023 12:45,6,PLN,101,"18,94",PAY,RECEIVED,APPROVED,EUR,"1,16",EUR,8836.80,,2081941,1387333745,Payout description,bc5e77d5e72f40e49c6c00f15aac3a2b,a759163a6e324c30a067be90b37241e7,,27/01/2023 20:21
06/02/2023 12:32,6,EUR,4,"3,37",PAY,RECEIVED,APPROVED,EUR,"0,63",EUR,8817.86,,15102365,6976798013,,7f2277f730f6469eb266e41f5c82ff8d,a759163a6e324c30a067be90b37241e7,0.046,27/01/2023 20:05
06/02/2023 12:30,6,PLN,50,"9,11",PAY,RECEIVED,APPROVED,EUR,"0,83",EUR,8814.49,,15101913,6976540701,,613ae136ceb940fb8db0cd8202c4fe1b,a759163a6e324c30a067be90b37241e7,0.2,27/01/2023 19:28
06/02/2023 12:21,6,EUR,25,"23,68",PAY,RECEIVED,APPROVED,EUR,"1,32",EUR,8805.38,,15101890,6976524431,,92359d774d6a4e8eb1f59b31cd188326,a759163a6e324c30a067be90b37241e7,0.046,27/01/2023 19:27
06/02/2023 12:15,6,EUR,300,"289,75",PAY,RECEIVED,APPROVED,EUR,"10,25",EUR,8781.70,,2081760,1387269639,Payout description,2218f5d8a6cb4bcbbf630560a6b50056,a759163a6e324c30a067be90b37241e7,0.052,27/01/2023 19:21
06/02/2023 12:06,6,EUR,60,"57,55",PAY,RECEIVED,APPROVED,EUR,"2,45",EUR,8491.95,,15101420,6976255201,,87ccd70322b84242b60869d488c4208c,a759163a6e324c30a067be90b37241e7,0.046,27/01/2023 18:52
06/02/2023 11:51,6,TRY,1,"-53,33",PAYOUT,SENT,APPROVED,EUR,"1,03",EUR,8434.40,,15100680,6975829293,,267afe4686ca4e2c91a439da63f1bf95,a759163a6e324c30a067be90b37241e7,,27/01/2023 17:53
06/02/2023 11:40,6,EUR,50,"47,87",PAY,RECEIVED,APPROVED,EUR,"2,13",EUR,8487.73,,15100651,6975813987,,b53451e2f25d43308aaa4005764defc9,a759163a6e324c30a067be90b37241e7,,27/01/2023 17:50
06/02/2023 11:27,6,EUR,250,"241,37",PAY,RECEIVED,APPROVED,EUR,"8,63",EUR,8439.86,,15100405,6975669355,,25abaf59338547b9b4ded0492d0c84c0,a759163a6e324c30a067be90b37241e7,0.046,27/01/2023 17:29
06/02/2023 11:22,6,EUR,10,"9,17",PAY,RECEIVED,APPROVED,EUR,"0,83",EUR,8198.49,,15099792,6975324241,,0b47174024584614836f1d6caacfa3f0,a759163a6e324c30a067be90b37241e7,0.046,27/01/2023 16:44
06/02/2023 11:21,6,EUR,145,"-146,95",PAYOUT,SENT,APPROVED,EUR,"1,95",EUR,8189.32,,15099544,6975197655,,b172a29385824a53b41e23517844d510,a759163a6e324c30a067be90b37241e7,0.046,27/01/2023 16:28
06/02/2023 10:34,6,TRY,71,"317,77",PAY,RECEIVED,APPROVED,EUR,"11,2",EUR,8336.27,,15099301,6975060801,,8eb45e8620ac4150880032cd35cc41e9,a759163a6e324c30a067be90b37241e7,,27/01/2023 16:11
06/02/2023 10:24,6,TRY,21,"93,62",PAY,RECEIVED,APPROVED,EUR,"3,67",EUR,8018.50,,15098360,6974518919,,9d3e89499e9148538f8b10380e707aa2,a759163a6e324c30a067be90b37241e7,0.046,27/01/2023 14:57
06/02/2023 10:12,6,TRY,10,"447,67",PAY,RECEIVED,APPROVED,EUR,"15,56",EUR,7924.88,,2081042,1386916251,Payout description,4e80c1324ae94c2e8bc136a9b7e08a7d,a759163a6e324c30a067be90b37241e7,0.052,27/01/2023 14:51
06/02/2023 10:06,6,TRY,380,"-20,58",PAYOUT,SENT,APPROVED,EUR,"0,7",EUR,7477.21,,2080898,1386852949,Payout description,7ebf6254710c439e90a22fdc63fe2265,a759163a6e324c30a067be90b37241e7,0.052,27/01/2023 14:06
06/02/2023 9:14,6,EUR,10,"9,17",PAY,RECEIVED,APPROVED,EUR,"0,83",EUR,7497.79,,15097811,6974134543,,e19e7f6239614a0db14e5d46e5aee49b,a759163a6e324c30a067be90b37241e7,0.046,27/01/2023 14:02
06/02/2023 9:09,6,EUR,"5,95","5,25",PAY,RECEIVED,APPROVED,EUR,"0,7",EUR,7488.62,,15097714,6974064993,,26cc0b03103e49a590e7706082a9348a,a759163a6e324c30a067be90b37241e7,0.046,27/01/2023 13:53
06/02/2023 9:08,6,EUR,"594,28","574,46",PAY,RECEIVED,APPROVED,EUR,"19,82",EUR,7483.37,,15097712,6974063185,,e221de4dddac4a5eb2348ebf72b825f7,a759163a6e324c30a067be90b37241e7,0.046,27/01/2023 13:52
06/02/2023 8:55,6,EUR,50,"47,87",PAY,RECEIVED,APPROVED,EUR,"2,13",EUR,6908.91,,15097307,6973767931,,6180cd94e7f645cdbdfdf2b28116fa94,a759163a6e324c30a067be90b37241e7,0.046,27/01/2023 13:12
06/02/2023 8:38,6,PLN,"55,4","10,18",PAY,RECEIVED,APPROVED,EUR,"0,86",EUR,6861.04,,15097216,6973676077,,f9a5ddffbcb74381b1baf5b939bd1545,a759163a6e324c30a067be90b37241e7,0.046,27/01/2023 12:59
06/02/2023 8:33,6,EUR,3,"2,4",PAY,RECEIVED,APPROVED,EUR,"0,6",EUR,6850.86,,15096865,6973368537,,6bdedd43d5ad483289fac6c23107defc,a759163a6e324c30a067be90b37241e7,0.046,27/01/2023 12:17
06/02/2023 5:21,6,TRY,4,"-211,24",PAYOUT,SENT,APPROVED,EUR,"2,59",EUR,6848.46,,15096416,6972977469,,1d3831932df94f198019d76eefea3623,a759163a6e324c30a067be90b37241e7,,27/01/2023 11:24
06/02/2023 2:51,6,EUR,"222,15","-224,88",PAYOUT,SENT,APPROVED,EUR,"2,73",EUR,7059.70,,2080494,1386646193,Payout description,163f08c3958941e48db32d64a78ce0da,a759163a6e324c30a067be90b37241e7,0.052,27/01/2023 11:21
06/02/2023 1:51,6,TRY,1,"-53,19",PAYOUT,SENT,APPROVED,EUR,"1,03",EUR,7284.58,,2080484,1386630949,Payout description,83b02dbbeb664618b8c9d354ed236bb5,a759163a6e324c30a067be90b37241e7,,27/01/2023 11:21
06/02/2023 0:20,6,TRY,7182,"320,48",PAY,RECEIVED,APPROVED,EUR,"11,29",EUR,7337.77,,15096188,6972783375,,ceb7ca29ceed44c9b0d2d8b641aeccbd,a759163a6e324c30a067be90b37241e7,0.046,27/01/2023 10:54
05/02/2023 23:21,5,PLN,"90,22","-21,05",PAYOUT,SENT,APPROVED,EUR,"0,71",EUR,7017.29,,15096070,6972716463,,25e999bc36854842a821376fab298f96,a759163a6e324c30a067be90b37241e7,0.046,27/01/2023 10:42
05/02/2023 23:21,5,TRY,40,"-2108,05",PAYOUT,SENT,APPROVED,EUR,"21,37",EUR,7038.34,,2080180,1386520175,Payout description,58e100e53a2542f09fdebd276e8863bd,a759163a6e324c30a067be90b37241e7,,27/01/2023 9:36
05/02/2023 22:51,5,TRY,347,"-183,3",PAYOUT,SENT,APPROVED,EUR,"2,31",EUR,9146.39,,15095337,6972219703,,5e54b77516d245ef86209a36f65daa04,a759163a6e324c30a067be90b37241e7,,27/01/2023 9:31
05/02/2023 22:49,5,TRY,30,"1340,72",PAY,RECEIVED,APPROVED,EUR,"45,56",EUR,9329.69,,15094660,6971787935,,9a967ac1c3ed4a59a44c323ed4a10061,a759163a6e324c30a067be90b37241e7,,27/01/2023 7:56
05/02/2023 22:36,5,EUR,300,"-303,5",PAYOUT,SENT,APPROVED,EUR,"3,5",EUR,7988.97,,2079854,1386397045,Payout description,aafc8a4614164b458b5401f018f8c15d,a759163a6e324c30a067be90b37241e7,0.052,27/01/2023 7:06
05/02/2023 22:21,5,PLN,412,"-94,42",PAYOUT,SENT,APPROVED,EUR,"1,43",EUR,8292.47,,2079686,1386297573,Payout description,2d1f5be281144586af9c551ce7d0567a,a759163a6e324c30a067be90b37241e7,,27/01/2023 4:51
05/02/2023 21:51,5,TRY,556,"-29,92",PAYOUT,SENT,APPROVED,EUR,"0,8",EUR,8386.89,,15093751,6971090775,,84f0db1c983b4baba6ab0517521f9e57,a759163a6e324c30a067be90b37241e7,,27/01/2023 3:15
05/02/2023 21:38,5,TRY,6266,"279,51",PAY,RECEIVED,APPROVED,EUR,"9,91",EUR,8416.81,,15093701,6971062549,,02c10e3cfa0a4c4fba8081c42dbebbc8,a759163a6e324c30a067be90b37241e7,,27/01/2023 2:58
05/02/2023 21:35,5,EUR,"9,5","8,69",PAY,RECEIVED,APPROVED,EUR,"0,81",EUR,8137.30,,15093670,6971038927,,58392d8172c244168ad1799dd726e25c,a759163a6e324c30a067be90b37241e7,,27/01/2023 2:44
05/02/2023 20:53,5,EUR,31,"29,49",PAY,RECEIVED,APPROVED,EUR,"1,51",EUR,8128.61,,15093609,6971006675,,e7b5c1f77c144946af7b7e1ca1140ccd,a759163a6e324c30a067be90b37241e7,0.011,27/01/2023 2:24
05/02/2023 20:50,5,PLN,135,"25,41",PAY,RECEIVED,APPROVED,EUR,"1,38",EUR,8099.12,,15093605,6971004637,,b4e2cedfc8e74d00b1bb69573cfdd2d9,a759163a6e324c30a067be90b37241e7,,27/01/2023 2:22
05/02/2023 20:37,5,EUR,5,"4,33",PAY,RECEIVED,APPROVED,EUR,"0,67",EUR,8073.71,,2079557,1386219585,Payout description,a5c61ffd6c534b13badaaaa39e35001d,a759163a6e324c30a067be90b37241e7,0.012,27/01/2023 2:21
05/02/2023 20:36,5,PLN,"53,4","9,74",PAY,RECEIVED,APPROVED,EUR,"0,85",EUR,8069.38,,2079392,1386120133,Payout description,1c8fa05ebee64620b2a97a7bb601f5a5,a759163a6e324c30a067be90b37241e7,0.052,26/01/2023 23:36
05/02/2023 20:36,5,TRY,13,"-686,96",PAYOUT,SENT,APPROVED,EUR,"7,3",EUR,8059.64,,15092917,6970633871,,7c35192638a144e6bf605022dcc2e376,a759163a6e324c30a067be90b37241e7,0.084,26/01/2023 23:24
05/02/2023 20:31,5,EUR,25,"23,68",PAY,RECEIVED,APPROVED,EUR,"1,32",EUR,8746.60,,15092659,6970507491,,864a2efed2c84b1f98ca8f3d5a6b08d4,a759163a6e324c30a067be90b37241e7,,26/01/2023 22:49
05/02/2023 20:28,5,EUR,20,"18,85",PAY,RECEIVED,APPROVED,EUR,"1,15",EUR,8722.92,,15092562,6970466807,,0ea6f9639c144f08b25d8be96111bf45,a759163a6e324c30a067be90b37241e7,0.046,26/01/2023 22:35
05/02/2023 20:24,5,EUR,25,"23,68",PAY,RECEIVED,APPROVED,EUR,"1,32",EUR,8704.07,,2079209,1386010747,Payout description,45e1ec38df71461dad0bf3b9ba7f0f4e,a759163a6e324c30a067be90b37241e7,0.052,26/01/2023 22:21
05/02/2023 20:21,5,TRY,10,"-528,55",PAYOUT,SENT,APPROVED,EUR,"5,73",EUR,8680.39,,15092311,6970366177,,99353f2e329344f6b6cba1b77c21f17f,a759163a6e324c30a067be90b37241e7,,26/01/2023 22:10
05/02/2023 20:17,5,EUR,17,"15,94",PAY,RECEIVED,APPROVED,EUR,"1,06",EUR,9208.94,,15091449,6969958363,,2d10f889a0a846c5ba530709ac93ca68,a759163a6e324c30a067be90b37241e7,,26/01/2023 20:53
05/02/2023 20:10,5,TRY,1052,"46,44",PAY,RECEIVED,APPROVED,EUR,"2,08",EUR,9193.00,,15090811,6969567615,,99bd7ea9960d4ce9b34b91d2297f2f4e,a759163a6e324c30a067be90b37241e7,0.046,26/01/2023 19:50
05/02/2023 20:06,5,TRY,6,"-317,33",PAYOUT,SENT,APPROVED,EUR,"3,64",EUR,9146.56,,15090590,6969446523,,0895b416f2914422b21a8f46dc0b3381,a759163a6e324c30a067be90b37241e7,0.046,26/01/2023 19:32
05/02/2023 20:06,5,TRY,800,"-42,75",PAYOUT,SENT,APPROVED,EUR,"0,92",EUR,9463.89,,15090110,6969150291,,af41ae92ff454a04a98a3173f1698256,a759163a6e324c30a067be90b37241e7,,26/01/2023 18:49
05/02/2023 19:53,5,TRY,800,"35,19",PAY,RECEIVED,APPROVED,EUR,"1,7",EUR,9506.64,,15090074,6969130425,,d78e9654efa1422a852a3b3c28ef9f74,a759163a6e324c30a067be90b37241e7,0.046,26/01/2023 18:46
05/02/2023 19:49,5,EUR,33,"31,42",PAY,RECEIVED,APPROVED,EUR,"1,58",EUR,9471.45,,15090012,6969093723,,ef63fca241914d98af0dfc879d41b0d3,a759163a6e324c30a067be90b37241e7,,26/01/2023 18:42
05/02/2023 19:43,5,EUR,15,"14,01",PAY,RECEIVED,APPROVED,EUR,"0,99",EUR,9440.03,,15089858,6969019435,,352c0cf8d8b64056b0ff17b7119da46f,a759163a6e324c30a067be90b37241e7,,26/01/2023 18:31
05/02/2023 19:42,5,TRY,19,"84,28",PAY,RECEIVED,APPROVED,EUR,"3,35",EUR,9426.02,,15089697,6968913379,,bd7bf846449c40b1ae496df008de1dd8,a759163a6e324c30a067be90b37241e7,,26/01/2023 18:15
05/02/2023 19:36,5,EUR,120,"-121,7",PAYOUT,SENT,APPROVED,EUR,"1,7",EUR,9341.74,,15089504,6968782347,,db561f806b744a228e8bf63ae7b60a61,a759163a6e324c30a067be90b37241e7,,26/01/2023 17:57
05/02/2023 19:20,5,EUR,20,"18,85",PAY,RECEIVED,APPROVED,EUR,"1,15",EUR,9463.44,,15089481,6968768403,,cf3ee38a5d8945bda06d86b8f582cbfd,a759163a6e324c30a067be90b37241e7,,26/01/2023 17:54
05/02/2023 19:07,5,TRY,200,"8,42",PAY,RECEIVED,APPROVED,EUR,"0,8",EUR,9444.59,,15089319,6968673177,,230662e4fff546909f476b08e0b5e08b,a759163a6e324c30a067be90b37241e7,0.046,26/01/2023 17:40
05/02/2023 19:01,5,TRY,500,"21,81",PAY,RECEIVED,APPROVED,EUR,"1,25",EUR,9436.17,,15089125,6968570013,,825cccb7bd1f41bd91f7a5a54b12be9b,a759163a6e324c30a067be90b37241e7,,26/01/2023 17:25
05/02/2023 18:56,5,EUR,10,"9,17",PAY,RECEIVED,APPROVED,EUR,"0,83",EUR,9414.36,,2078495,1385661321,Payout description,2a894347c54c4616aeb72d9d1b215a66,a759163a6e324c30a067be90b37241e7,,26/01/2023 17:21
05/02/2023 18:53,5,EUR,20,"18,85",PAY,RECEIVED,APPROVED,EUR,"1,15",EUR,9405.19,,2078491,1385646877,Payout description,9f89fb28547b4c0794eb31ff48fd2940,a759163a6e324c30a067be90b37241e7,0.052,26/01/2023 17:21
05/02/2023 18:46,5,EUR,175,"168,81",PAY,RECEIVED,APPROVED,EUR,"6,19",EUR,9386.34,,2078465,1385628235,Payout description,494e36e85c5846c1818b554efb11d857,a759163a6e324c30a067be90b37241e7,0.052,26/01/2023 17:06
05/02/2023 18:06,5,TRY,67,"-354,3",PAYOUT,SENT,APPROVED,EUR,"4,01",EUR,9217.53,,15088913,6968434641,,364de1fe424b477cb443022503e73296,a759163a6e324c30a067be90b37241e7,,26/01/2023 17:05
05/02/2023 16:59,5,EUR,20,"18,85",PAY,RECEIVED,APPROVED,EUR,"1,15",EUR,9571.83,,2078390,1385585949,Payout description,47509ce853bc4dd089a9307e6080deeb,a759163a6e324c30a067be90b37241e7,,26/01/2023 16:36
05/02/2023 16:22,5,TRY,400,"17,34",PAY,RECEIVED,APPROVED,EUR,"1,1",EUR,9552.98,,15088483,6968195531,,c7fca557899347d8a7fad7e2d0729acb,a759163a6e324c30a067be90b37241e7,0.046,26/01/2023 16:28
05/02/2023 16:03,5,EUR,26,"24,65",PAY,RECEIVED,APPROVED,EUR,"1,35",EUR,9535.64,,15088472,6968186329,,8011d02fd89546c5907387e75e1932db,a759163a6e324c30a067be90b37241e7,,26/01/2023 16:27
05/02/2023 15:57,5,PLN,125,"23,49",PAY,RECEIVED,APPROVED,EUR,"1,31",EUR,9510.99,,15088312,6968082223,,b235a092d89546c08cb36e52974fb0b5,a759163a6e324c30a067be90b37241e7,,26/01/2023 16:12
05/02/2023 15:55,5,PLN,25,"4,29",PAY,RECEIVED,APPROVED,EUR,"0,67",EUR,9487.50,,15088230,6968015893,,b0753c3cfc7f436f9310e5d45c2025d8,a759163a6e324c30a067be90b37241e7,,26/01/2023 16:02
05/02/2023 15:47,5,EUR,55,"52,71",PAY,RECEIVED,APPROVED,EUR,"2,29",EUR,9483.21,,15088024,6967887197,,64ccf1a761884163b243e27bbe492c51,a759163a6e324c30a067be90b37241e7,,26/01/2023 15:42
05/02/2023 15:37,5,PLN,102,"19,08",PAY,RECEIVED,APPROVED,EUR,"1,16",EUR,9430.50,,15087847,6967760709,,89c4cd336cd04ef5bfb3b147a989d98b,a759163a6e324c30a067be90b37241e7,0.046,26/01/2023 15:22
05/02/2023 15:35,5,EUR,10,"9,17",PAY,RECEIVED,APPROVED,EUR,"0,83",EUR,9411.42,,15087612,6967603655,,4a08d8881e144ba99dfdf6d582bfefe7,a759163a6e324c30a067be90b37241e7,,26/01/2023 15:00
05/02/2023 15:21,5,TRY,1,"-53,32",PAYOUT,SENT,APPROVED,EUR,"1,03",EUR,9402.25,,15087599,6967591545,,ddece8ec4e264687acbdc3eff3d60130,a759163a6e324c30a067be90b37241e7,,26/01/2023 14:57
05/02/2023 15:20,5,PLN,40,"7,17",PAY,RECEIVED,APPROVED,EUR,"0,76",EUR,9455.57,,15087485,6967514061,,46bf1673796d4070a49ed280813df4f0,a759163a6e324c30a067be90b37241e7,,26/01/2023 14:45
05/02/2023 15:02,5,TRY,79,"3,02",PAY,RECEIVED,APPROVED,EUR,"0,62",EUR,9448.40,,15086954,6967140325,,0557b8040bac40ffbf33037b8e140cf0,a759163a6e324c30a067be90b37241e7,0.046,26/01/2023 13:45
05/02/2023 14:50,5,EUR,"200,51","193,49",PAY,RECEIVED,APPROVED,EUR,"7,02",EUR,9445.38,,15086903,6967102693,,163fd5e0bc1742ce84ce93556ee712cc,a759163a6e324c30a067be90b37241e7,0.046,26/01/2023 13:39
05/02/2023 14:36,5,PLN,200,"-45,81",PAYOUT,SENT,APPROVED,EUR,"0,95",EUR,9251.89,,15086711,6966952289,,c23a07da0c494be089b15c288c206fe3,a759163a6e324c30a067be90b37241e7,0.046,26/01/2023 13:14
05/02/2023 14:29,5,EUR,10,"9,17",PAY,RECEIVED,APPROVED,EUR,"0,83",EUR,9297.70,,15086576,6966841849,,ae8a44ab781f43618bac274fb6e197c4,a759163a6e324c30a067be90b37241e7,0.199,26/01/2023 12:56
05/02/2023 14:24,5,TRY,331,"14,26",PAY,RECEIVED,APPROVED,EUR,1,EUR,9288.53,,15086110,6966476013,,4c9ec13b7e3042dbb1a691c385974f4d,a759163a6e324c30a067be90b37241e7,,26/01/2023 11:51
05/02/2023 14:16,5,EUR,"6,57","5,85",PAY,RECEIVED,APPROVED,EUR,"0,72",EUR,9274.27,,15085992,6966394971,,0d121ce11bf945cfb70410948d8a37a7,a759163a6e324c30a067be90b37241e7,0.199,26/01/2023 11:37
05/02/2023 13:48,5,TRY,7841,"349,39",PAY,RECEIVED,APPROVED,EUR,"12,26",EUR,9268.42,,,,cb amount deducted -Customer Number:59626169,88930f6ec9254dd5aa3306e7d5e64d07,a759163a6e324c30a067be90b37241e7,,26/01/2023 11:35
05/02/2023 13:41,5,PLN,"45,9","8,31",PAY,RECEIVED,APPROVED,EUR,"0,8",EUR,8919.03,,15085939,6966345567,,56486bb6ecff4466bfd2096542f311d5,a759163a6e324c30a067be90b37241e7,0.199,26/01/2023 11:28
05/02/2023 13:39,5,PLN,6,"0,65",PAY,RECEIVED,APPROVED,EUR,"0,54",EUR,8910.72,,15085798,6966240093,,36e35ff7f6764aa482da65f97064d025,a759163a6e324c30a067be90b37241e7,0.199,26/01/2023 11:09
05/02/2023 13:16,5,EUR,15,"14,01",PAY,RECEIVED,APPROVED,EUR,"0,99",EUR,8910.07,,15085611,6966099647,,f287ba4d9e9d4f3db2a4c7fbc792bd3b,a759163a6e324c30a067be90b37241e7,0.046,26/01/2023 10:43
05/02/2023 13:04,5,TRY,300,"12,88",PAY,RECEIVED,APPROVED,EUR,"0,95",EUR,8896.06,,15085117,6965767825,,e01bcfbb99ad48e2ad22171d5ec8f24b,a759163a6e324c30a067be90b37241e7,0.046,26/01/2023 9:44
05/02/2023 13:01,5,TRY,1,"44,12",PAY,RECEIVED,APPROVED,EUR,2,EUR,8883.18,,15084817,6965572791,,01661a2cbb1944bc97620bb90d97cd42,a759163a6e324c30a067be90b37241e7,0.046,26/01/2023 8:57
05/02/2023 12:44,5,TRY,550,"24,03",PAY,RECEIVED,APPROVED,EUR,"1,33",EUR,8839.06,,15084739,6965511907,,55e79dfc37d644a7a3d58e7f6e1c8982,a759163a6e324c30a067be90b37241e7,,26/01/2023 8:43
05/02/2023 12:28,5,TRY,50,"1,72",PAY,RECEIVED,APPROVED,EUR,"0,58",EUR,8815.03,,15084655,6965461351,,0700895c6bdd456987c774c31a189b9f,a759163a6e324c30a067be90b37241e7,,26/01/2023 8:30
05/02/2023 12:22,5,TRY,13,"57,51",PAY,RECEIVED,APPROVED,EUR,"2,45",EUR,8813.31,,15084391,6965283861,,46751e07e61347c3a36b206492ccd223,a759163a6e324c30a067be90b37241e7,,26/01/2023 7:43
05/02/2023 12:07,5,EUR,37,"35,29",PAY,RECEIVED,APPROVED,EUR,"1,71",EUR,8755.80,,15084253,6965166445,,c9e5f5bff2554d1096d551b7580e3a7a,a759163a6e324c30a067be90b37241e7,,26/01/2023 7:09
05/02/2023 11:48,5,EUR,50,"47,87",PAY,RECEIVED,APPROVED,EUR,"2,13",EUR,8720.51,,2077047,1384874245,Payout description,440a016627f64edf9b7156d8872fe1cf,a759163a6e324c30a067be90b37241e7,0.052,26/01/2023 7:06
05/02/2023 11:34,5,SEK,10456,"835,11",PAY,RECEIVED,APPROVED,EUR,"28,57",EUR,8672.64,,15084216,6965130963,,823e92e895374310a82733bef56f08d2,a759163a6e324c30a067be90b37241e7,,26/01/2023 6:58
05/02/2023 11:32,5,SEK,40,"3196,19",PAY,RECEIVED,APPROVED,EUR,"107,89",EUR,7837.53,,2076978,1384830651,Payout description,453d678f3c8a44728f129caae0517867,a759163a6e324c30a067be90b37241e7,0.052,26/01/2023 6:21
05/02/2023 11:26,5,EUR,30,"28,52",PAY,RECEIVED,APPROVED,EUR,"1,48",EUR,4641.34,,15083984,6964992849,,9ce9220ebb454f96a1e7d04225f0082b,a759163a6e324c30a067be90b37241e7,,26/01/2023 6:07
05/02/2023 11:19,5,EUR,"36,5","34,81",PAY,RECEIVED,APPROVED,EUR,"1,69",EUR,4612.82,,2076932,1384794895,Payout description,81b98565b11f45d18d73a002552a412e,a759163a6e324c30a067be90b37241e7,,26/01/2023 5:51
05/02/2023 11:06,5,TRY,500,"21,81",PAY,RECEIVED,APPROVED,EUR,"1,25",EUR,4578.01,,15083798,6964862043,,edd2b634e46b4112bf653d9f86cf7198,a759163a6e324c30a067be90b37241e7,,26/01/2023 5:08
05/02/2023 11:05,5,EUR,26,"24,65",PAY,RECEIVED,APPROVED,EUR,"1,35",EUR,4556.20,,15083776,6964849043,,6da46f08725d4be48562bd31968c64e1,a759163a6e324c30a067be90b37241e7,,26/01/2023 5:01
05/02/2023 10:51,5,TRY,4,"-211,73",PAYOUT,SENT,APPROVED,EUR,"2,6",EUR,4531.55,,15083769,6964842583,,22d80a64e6ff4b26971c0a3dc0a798c6,a759163a6e324c30a067be90b37241e7,,26/01/2023 4:58
05/02/2023 10:48,5,TRY,100,"3,96",PAY,RECEIVED,APPROVED,EUR,"0,65",EUR,4743.28,,15083701,6964780253,,fc0c056413914728965e6b007eda4d69,a759163a6e324c30a067be90b37241e7,,26/01/2023 4:23
05/02/2023 10:43,5,EUR,10,"9,17",PAY,RECEIVED,APPROVED,EUR,"0,83",EUR,4739.32,,15083250,6964484323,,37fc70b70b674f4e8ac78beccdcb8f2c,a759163a6e324c30a067be90b37241e7,,26/01/2023 1:12
05/02/2023 10:11,5,PLN,80,"14,85",PAY,RECEIVED,APPROVED,EUR,"1,02",EUR,4730.15,,2076716,1384580335,Payout description,28573dc8f785469bae771c5078207501,a759163a6e324c30a067be90b37241e7,,26/01/2023 0:51
05/02/2023 10:07,5,PLN,20,"3,33",PAY,RECEIVED,APPROVED,EUR,"0,63",EUR,4715.30,,2076715,1384579795,Payout description,b3dce98941b34049837a31403f00947d,a759163a6e324c30a067be90b37241e7,,26/01/2023 0:51
05/02/2023 10:06,5,PLN,999,"-226,79",PAYOUT,SENT,APPROVED,EUR,"2,75",EUR,4711.97,,15083133,6964430619,,04b81d14bed84e8daca5c4ca7f1fefa3,a759163a6e324c30a067be90b37241e7,0.199,26/01/2023 0:43
05/02/2023 10:05,5,PLN,15,"2,37",PAY,RECEIVED,APPROVED,EUR,"0,6",EUR,4938.76,,15083122,6964424269,,c9ea04d8ac714c08ac495a2b13cf1623,a759163a6e324c30a067be90b37241e7,0.199,26/01/2023 0:40
05/02/2023 9:51,5,PLN,90,"-20,9",PAYOUT,SENT,APPROVED,EUR,"0,71",EUR,4936.39,,15083113,6964417191,,924cece5eed6413d8b9bb192475335c3,a759163a6e324c30a067be90b37241e7,0.199,26/01/2023 0:37
05/02/2023 9:51,5,PLN,214,"-48,98",PAYOUT,SENT,APPROVED,EUR,"0,98",EUR,4957.29,,15083082,6964396469,,3539c6f67aca4c29aad2ecacd82e4563,a759163a6e324c30a067be90b37241e7,0.199,26/01/2023 0:29
05/02/2023 9:41,5,EUR,"51,02","48,86",PAY,RECEIVED,APPROVED,EUR,"2,16",EUR,5006.27,,15083062,6964382587,,ce8034943e984d84af4a439b30a2fc7e,a759163a6e324c30a067be90b37241e7,0.199,26/01/2023 0:24
05/02/2023 9:36,5,PLN,50,"-11,84",PAYOUT,SENT,APPROVED,EUR,"0,62",EUR,4957.41,,15083054,6964378819,,b73a59866f884e20804c2c6f5dcc96dc,a759163a6e324c30a067be90b37241e7,0.046,26/01/2023 0:22
05/02/2023 9:32,5,PLN,20,"3,33",PAY,RECEIVED,APPROVED,EUR,"0,63",EUR,4969.25,,15082987,6964347705,,eb40d2ad672441218c64daf86e1dbe73,a759163a6e324c30a067be90b37241e7,0.199,26/01/2023 0:08
05/02/2023 9:21,5,TRY,200,"-11,07",PAYOUT,SENT,APPROVED,EUR,"0,61",EUR,4965.92,,15082988,6964347729,,c93af9d581a1492a8d9175265b57fa82,a759163a6e324c30a067be90b37241e7,0.046,26/01/2023 0:08
05/02/2023 8:17,5,PLN,61,"11,2",PAY,RECEIVED,APPROVED,EUR,"0,9",EUR,4976.99,,15082916,6964316439,,d39f21cb06c64ded859460fc7e8bf0ca,a759163a6e324c30a067be90b37241e7,,25/01/2023 23:56
05/02/2023 8:04,5,PLN,61,"11,2",PAY,RECEIVED,APPROVED,EUR,"0,9",EUR,4965.79,,15082907,6964313785,,15f6ec1671784145a3618e379116931d,a759163a6e324c30a067be90b37241e7,0.046,25/01/2023 23:55
05/02/2023 7:55,5,TRY,241,"10,24",PAY,RECEIVED,APPROVED,EUR,"0,87",EUR,4954.59,,2076640,1384532345,Payout description,74b5157bf0b54cf9b2768ae7ff2de908,a759163a6e324c30a067be90b37241e7,,25/01/2023 23:51
05/02/2023 7:24,5,EUR,20,"18,85",PAY,RECEIVED,APPROVED,EUR,"1,15",EUR,4944.35,,15082867,6964292101,,ad877a92341949f0aa4cca9671c08c6f,a759163a6e324c30a067be90b37241e7,,25/01/2023 23:47
05/02/2023 6:21,5,PLN,60,"-14,1",PAYOUT,SENT,APPROVED,EUR,"0,64",EUR,4925.50,,15082660,6964181547,,14452dd28c7740e887d542902227e11c,a759163a6e324c30a067be90b37241e7,,25/01/2023 23:11
05/02/2023 5:30,5,PLN,20,"3,33",PAY,RECEIVED,APPROVED,EUR,"0,63",EUR,4939.60,,2076558,1384436393,Payout description,1066fa064b344765ae3ece09395d3f37,a759163a6e324c30a067be90b37241e7,,25/01/2023 23:06
05/02/2023 4:15,5,PLN,20,"3,33",PAY,RECEIVED,APPROVED,EUR,"0,63",EUR,4936.27,,15082436,6964049319,,5c713baf1c914b62808c0f7febf8c7be,a759163a6e324c30a067be90b37241e7,,25/01/2023 22:35
05/02/2023 3:36,5,TRY,20,"-1056,59",PAYOUT,SENT,APPROVED,EUR,"10,96",EUR,4932.94,,15082275,6963982759,,4c8b5e84bc03445485f8ec2f314f2df7,a759163a6e324c30a067be90b37241e7,0.046,25/01/2023 22:18
05/02/2023 2:41,5,TRY,250,"10,65",PAY,RECEIVED,APPROVED,EUR,"0,88",EUR,5989.53,,15082134,6963914575,,2645428754394747be8f781d811dfb83,a759163a6e324c30a067be90b37241e7,,25/01/2023 22:06
05/02/2023 2:06,5,EUR,"48,13","-49,12",PAYOUT,SENT,APPROVED,EUR,"0,99",EUR,5978.88,,15082099,6963899677,,13b44a8d887b4efaa82699a2bd8d5e5d,a759163a6e324c30a067be90b37241e7,,25/01/2023 22:01
05/02/2023 1:51,5,PLN,700,"-159,06",PAYOUT,SENT,APPROVED,EUR,"2,07",EUR,6028.00,,2076308,1384290743,Payout description,183b6ea69f6f49189e4e393b8124d815,a759163a6e324c30a067be90b37241e7,,25/01/2023 21:51
05/02/2023 1:02,5,TRY,1249,"556,85",PAY,RECEIVED,APPROVED,EUR,"19,23",EUR,6187.06,,2076245,1384268869,Payout description,f594f8de49ac47aa901d23be9e3ef124,a759163a6e324c30a067be90b37241e7,0.052,25/01/2023 21:36
05/02/2023 0:37,5,TRY,202,"8,5",PAY,RECEIVED,APPROVED,EUR,"0,81",EUR,5630.21,,15081793,6963754793,,b1227bc75d5542bfa336b0ac0f9ee7f0,a759163a6e324c30a067be90b37241e7,0.046,25/01/2023 21:28
05/02/2023 0:16,5,TRY,144,"5,92",PAY,RECEIVED,APPROVED,EUR,"0,72",EUR,5621.71,,15081164,6963418305,,aa4a79ed67af42d1bfd598f8a54074ab,a759163a6e324c30a067be90b37241e7,,25/01/2023 20:25
04/02/2023 23:51,4,TRY,22,"-1162,2",PAYOUT,SENT,APPROVED,EUR,"12,01",EUR,5615.79,,15081057,6963359149,,1bd34dd5547f486ab248e27e1f119040,a759163a6e324c30a067be90b37241e7,,25/01/2023 20:14
04/02/2023 23:18,4,SEK,51,"407,07",PAY,RECEIVED,APPROVED,EUR,"14,2",EUR,6777.99,,2075950,1384161331,Payout description,10cc07a9149c4c43a5ce004c7eb4f85a,a759163a6e324c30a067be90b37241e7,0.052,25/01/2023 19:51
04/02/2023 23:11,4,PLN,90,"16,77",PAY,RECEIVED,APPROVED,EUR,"1,09",EUR,6370.92,,2075890,1384145689,Payout description,b99e29ed507b449b9f22a48d1da90d06,a759163a6e324c30a067be90b37241e7,0.225,25/01/2023 19:36
04/02/2023 22:44,4,PLN,51,"9,29",PAY,RECEIVED,APPROVED,EUR,"0,83",EUR,6354.15,,2075814,1384121875,Payout description,c3a0326799a1437db7868c27779b06c2,a759163a6e324c30a067be90b37241e7,0.225,25/01/2023 19:21
04/02/2023 22:36,4,EUR,"150,41","-152,42",PAYOUT,SENT,APPROVED,EUR,"2,01",EUR,6344.86,,15080224,6962856077,,43dcf0ab2611459cba012330ce6b6d45,a759163a6e324c30a067be90b37241e7,0.046,25/01/2023 19:05
04/02/2023 22:34,4,PLN,100,"18,69",PAY,RECEIVED,APPROVED,EUR,"1,15",EUR,6497.28,,15080062,6962760657,,e88f8e0e3b284c78b59a109690d1e424,a759163a6e324c30a067be90b37241e7,,25/01/2023 18:53
04/02/2023 22:25,4,TRY,4281,"1909,87",PAY,RECEIVED,APPROVED,EUR,"64,68",EUR,6478.59,,15080050,6962754209,,00369eb474264e77a8dac2658f5f8be2,a759163a6e324c30a067be90b37241e7,0.046,25/01/2023 18:51
04/02/2023 22:21,4,TRY,137,"-723,92",PAYOUT,SENT,APPROVED,EUR,"7,67",EUR,4568.72,,15080036,6962747821,,3e9c2263762b41748b4cf0960305e0b6,a759163a6e324c30a067be90b37241e7,0.046,25/01/2023 18:51
04/02/2023 22:06,4,TRY,20,"-1,57",PAYOUT,SENT,APPROVED,EUR,"0,52",EUR,5292.64,,15079450,6962356173,,bb5ba3899ba34f3dbeb2ad60e6ca1bba,a759163a6e324c30a067be90b37241e7,0.199,25/01/2023 17:57
04/02/2023 21:44,4,TRY,300,"12,88",PAY,RECEIVED,APPROVED,EUR,"0,95",EUR,5294.21,,15078728,6961862927,,92bb585ffd88410ca5d727bb19223f65,a759163a6e324c30a067be90b37241e7,,25/01/2023 16:57
04/02/2023 21:36,4,TRY,20,"-1056,59",PAYOUT,SENT,APPROVED,EUR,"10,96",EUR,5281.33,,2075452,1383929139,Payout description,d412c92b83ea4bc6a9cecdce0bd6d1e7,a759163a6e324c30a067be90b37241e7,,25/01/2023 16:36
04/02/2023 21:25,4,TRY,1,"44,12",PAY,RECEIVED,APPROVED,EUR,2,EUR,6337.92,,15078468,6961675345,,4532bf89a5ff495b8786181623eeca58,a759163a6e324c30a067be90b37241e7,0.046,25/01/2023 16:31
04/02/2023 21:19,4,TRY,12785,"570,02",PAY,RECEIVED,APPROVED,EUR,"19,67",EUR,6293.80,,15078351,6961583705,,5118b87c614f42c28301cf286a436c1e,a759163a6e324c30a067be90b37241e7,0.046,25/01/2023 16:20
04/02/2023 21:06,4,TRY,117,"-62,29",PAYOUT,SENT,APPROVED,EUR,"1,12",EUR,5723.78,,15078327,6961566113,,1a3c834cd0c84e9da7543b46498aaadf,a759163a6e324c30a067be90b37241e7,0.199,25/01/2023 16:17
04/02/2023 21:06,4,TRY,20,"-1056,59",PAYOUT,SENT,APPROVED,EUR,"10,96",EUR,5786.07,,15078044,6961371071,,2b4a1e62d8ad4ca39a845cf534addbb5,a759163a6e324c30a067be90b37241e7,0.046,25/01/2023 15:52
04/02/2023 20:51,4,EUR,"2,51","1,92",PAY,RECEIVED,APPROVED,EUR,"0,59",EUR,6842.66,,2075365,1383865549,Payout description,7ad07324157646369f6f48cfad058db8,a759163a6e324c30a067be90b37241e7,0.052,25/01/2023 15:51
04/02/2023 20:37,4,PLN,15,"2,37",PAY,RECEIVED,APPROVED,EUR,"0,6",EUR,6840.74,,15077924,6961284851,,93b95457cfa941509343dca84960dee3,a759163a6e324c30a067be90b37241e7,,25/01/2023 15:42
04/02/2023 20:37,4,PLN,"10,15","1,44",PAY,RECEIVED,APPROVED,EUR,"0,57",EUR,6838.37,,15077689,6961106411,,dd73cf3f0d2246a8bf7aa5e4d56e3018,a759163a6e324c30a067be90b37241e7,,25/01/2023 15:18
04/02/2023 20:26,4,EUR,"3,57","2,95",PAY,RECEIVED,APPROVED,EUR,"0,62",EUR,6836.93,,,,"cb  amount deducted, Customer Number:10457263",76384d401094474aafaeffe1ef8f1da8,a759163a6e324c30a067be90b37241e7,,25/01/2023 14:39
04/02/2023 20:22,4,EUR,2,"1,43",PAY,RECEIVED,APPROVED,EUR,"0,57",EUR,6833.98,,15077131,6960620325,,f106cbcec1bc4077a7843fc531d0a7eb,a759163a6e324c30a067be90b37241e7,,25/01/2023 14:13
04/02/2023 20:09,4,EUR,20,"18,85",PAY,RECEIVED,APPROVED,EUR,"1,15",EUR,6832.55,,2075125,1383749643,Payout description,7ca53dd302f243ef97cc32c2da3f1b28,a759163a6e324c30a067be90b37241e7,0.052,25/01/2023 14:06
04/02/2023 19:55,4,PLN,7,"0,83",PAY,RECEIVED,APPROVED,EUR,"0,55",EUR,6813.70,,2075119,1383737309,Payout description,061ae43653b54d0386a0caa495d4a65a,a759163a6e324c30a067be90b37241e7,,25/01/2023 14:06
04/02/2023 19:35,4,EUR,10,"9,17",PAY,RECEIVED,APPROVED,EUR,"0,83",EUR,6812.87,,15076972,6960481283,,c20fb9c462f74a8993765569dc770292,a759163a6e324c30a067be90b37241e7,,25/01/2023 13:59
04/02/2023 19:10,4,SEK,102,"814,65",PAY,RECEIVED,APPROVED,EUR,"27,89",EUR,6803.70,,15076801,6960338707,,f8dd4c31c0bc4f2882dda35d88e3f605,a759163a6e324c30a067be90b37241e7,0.046,25/01/2023 13:36
04/02/2023 18:52,4,TRY,2,"88,74",PAY,RECEIVED,APPROVED,EUR,"3,5",EUR,5989.05,,2075045,1383699733,Payout description,4b38c5b575a14d16b7cdea8d6a229702,a759163a6e324c30a067be90b37241e7,,25/01/2023 13:36
04/02/2023 18:45,4,TRY,500,"21,81",PAY,RECEIVED,APPROVED,EUR,"1,25",EUR,5900.31,,15076778,6960321627,,5eaf88fd19d649d29217150cbf978070,a759163a6e324c30a067be90b37241e7,0.046,25/01/2023 13:35
04/02/2023 18:33,4,EUR,103,"99,15",PAY,RECEIVED,APPROVED,EUR,"3,85",EUR,5878.50,,15076771,6960313415,,35c37bc0ffac4aeab4ce83542c447371,a759163a6e324c30a067be90b37241e7,,25/01/2023 13:34
04/02/2023 18:10,4,SEK,140,"10,68",PAY,RECEIVED,APPROVED,EUR,"0,88",EUR,5779.35,,15076392,6960026855,,b8d5188802824a97be68f431656004a9,a759163a6e324c30a067be90b37241e7,,25/01/2023 12:56
04/02/2023 17:49,4,PLN,75,"13,89",PAY,RECEIVED,APPROVED,EUR,"0,99",EUR,5768.67,,15076297,6959941973,,c88e79ad1e814d84ac67af79ce4f1f2b,a759163a6e324c30a067be90b37241e7,,25/01/2023 12:44
04/02/2023 17:46,4,PLN,9,"1,22",PAY,RECEIVED,APPROVED,EUR,"0,56",EUR,5754.78,,2074889,1383609007,Payout description,5bc4cfc908704b2e8433dc8fdce14a65,a759163a6e324c30a067be90b37241e7,0.052,25/01/2023 12:21
04/02/2023 17:36,4,EUR,"18,47","17,36",PAY,RECEIVED,APPROVED,EUR,"1,11",EUR,5753.56,,2074862,1383602487,Payout description,2e16b3bcc9aa43ca98a27d12700c832d,a759163a6e324c30a067be90b37241e7,0.052,25/01/2023 12:06
04/02/2023 17:36,4,TRY,3242,"-171,7",PAYOUT,SENT,APPROVED,EUR,"2,2",EUR,5736.20,,15075897,6959550205,,835cb8f82b4e4fbe9c3e7ad2700f9ffb,a759163a6e324c30a067be90b37241e7,,25/01/2023 11:47
04/02/2023 17:30,4,EUR,10,"9,17",PAY,RECEIVED,APPROVED,EUR,"0,83",EUR,5907.90,,2074655,1383501855,Payout description,66bf3efcacbd444b96375232d4c0721c,a759163a6e324c30a067be90b37241e7,0.052,25/01/2023 10:51
04/02/2023 17:25,4,EUR,90,"86,57",PAY,RECEIVED,APPROVED,EUR,"3,43",EUR,5898.73,,2074494,1383435523,Payout description,d6f5b822b76644a999c89621e7a7face,a759163a6e324c30a067be90b37241e7,0.052,25/01/2023 9:51
04/02/2023 17:21,4,TRY,511,"22,29",PAY,RECEIVED,APPROVED,EUR,"1,27",EUR,5812.16,,15074884,6958797257,,b5fdccb8520f4a47bebd9ae2d8cdb35d,a759163a6e324c30a067be90b37241e7,0.2,25/01/2023 9:48
04/02/2023 17:21,4,EUR,"157,09","-159,17",PAYOUT,SENT,APPROVED,EUR,"2,08",EUR,5789.87,,2074344,1383382367,Payout description,e847785819364a5baa65d72212b3bc37,a759163a6e324c30a067be90b37241e7,,25/01/2023 8:51
04/02/2023 17:21,4,EUR,68,"-69,18",PAYOUT,SENT,APPROVED,EUR,"1,18",EUR,5949.04,,15074005,6958032439,,f2e50e23a7ae4a0d8f604c1f263bb739,a759163a6e324c30a067be90b37241e7,0.046,25/01/2023 7:14
04/02/2023 17:06,4,TRY,4,"-211,73",PAYOUT,SENT,APPROVED,EUR,"2,6",EUR,6018.22,,2074052,1383213787,Payout description,63c92e6e14ca47cca294215da24bd22b,a759163a6e324c30a067be90b37241e7,,25/01/2023 5:51
04/02/2023 16:51,4,TRY,700,"-37,47",PAYOUT,SENT,APPROVED,EUR,"0,87",EUR,6229.95,,15073522,6957584165,,61a5dfdf9d114b7f875a04e80448b5b4,a759163a6e324c30a067be90b37241e7,,25/01/2023 4:20
04/02/2023 16:51,4,TRY,212,"-11,71",PAYOUT,SENT,APPROVED,EUR,"0,62",EUR,6267.42,,15073518,6957579601,,e5525b29576f40329dcd57f914085993,a759163a6e324c30a067be90b37241e7,,25/01/2023 4:18
04/02/2023 16:49,4,TRY,150,"6,18",PAY,RECEIVED,APPROVED,EUR,"0,73",EUR,6279.13,,2073941,1383140741,Payout description,e6e8f458d8084801847f8773e6b74ede,a759163a6e324c30a067be90b37241e7,,25/01/2023 4:06
04/02/2023 16:06,4,TRY,15,"-79,72",PAYOUT,SENT,APPROVED,EUR,"1,29",EUR,6272.95,,15073366,6957498121,,eb9b01413d1340a3bfb21b1d8a26a075,a759163a6e324c30a067be90b37241e7,,25/01/2023 3:30
04/02/2023 16:00,4,TRY,35,"155,68",PAY,RECEIVED,APPROVED,EUR,"5,75",EUR,6352.67,,15073355,6957490253,,e88a878b68be4c6bbb206976fb633961,a759163a6e324c30a067be90b37241e7,,25/01/2023 3:26
04/02/2023 15:53,4,TRY,245,"10,43",PAY,RECEIVED,APPROVED,EUR,"0,87",EUR,6196.99,,15073342,6957483581,,a806936cbf514c70a2282d213aad5a28,a759163a6e324c30a067be90b37241e7,0.199,25/01/2023 3:21
04/02/2023 15:51,4,TRY,"172,69","-9,63",PAYOUT,SENT,APPROVED,EUR,"0,6",EUR,6186.56,,15073102,6957344685,,3bc627530d514f37a639dc90966ce002,a759163a6e324c30a067be90b37241e7,0.046,25/01/2023 1:55
04/02/2023 15:49,4,EUR,"50,31","48,17",PAY,RECEIVED,APPROVED,EUR,"2,14",EUR,6196.19,,15072776,6957187209,,9ac467e065a941c3a2180e4c7b065644,a759163a6e324c30a067be90b37241e7,0.199,25/01/2023 0:23
04/02/2023 15:36,4,EUR,10,"9,17",PAY,RECEIVED,APPROVED,EUR,"0,83",EUR,6148.02,,15072721,6957162397,,636b377571094aff803841d56a1d6c15,a759163a6e324c30a067be90b37241e7,0.199,25/01/2023 0:12
04/02/2023 15:28,4,EUR,5,"4,33",PAY,RECEIVED,APPROVED,EUR,"0,67",EUR,6138.85,,15072703,6957157003,,16ca700a556349d1925266f612088f6c,a759163a6e324c30a067be90b37241e7,0.199,25/01/2023 0:09
04/02/2023 14:52,4,SEK,10,"798,67",PAY,RECEIVED,APPROVED,EUR,"27,35",EUR,6134.52,,2073783,1383030339,Payout description,f2cc8f92b19e46e081fba98e94e269b6,a759163a6e324c30a067be90b37241e7,,25/01/2023 0:06
04/02/2023 14:51,4,TRY,"114,3","-6,54",PAYOUT,SENT,APPROVED,EUR,"0,56",EUR,5335.85,,15072370,6956995911,,e6a36a1daf94473cb5aea7f14a82927d,a759163a6e324c30a067be90b37241e7,0.046,24/01/2023 23:16
04/02/2023 14:49,4,TRY,100,"3,96",PAY,RECEIVED,APPROVED,EUR,"0,65",EUR,5342.39,,2073657,1382947537,Payout description,cdffc0641f7e4e8ab6e1e183f72429a0,a759163a6e324c30a067be90b37241e7,0.052,24/01/2023 22:36
04/02/2023 14:43,4,TRY,40,"1784,47",PAY,RECEIVED,APPROVED,EUR,"60,47",EUR,5338.43,,15071984,6956805387,,e191d0861a9e4ae7833a79aed2ad942b,a759163a6e324c30a067be90b37241e7,0.199,24/01/2023 22:22
04/02/2023 14:42,4,EUR,25,"23,68",PAY,RECEIVED,APPROVED,EUR,"1,32",EUR,3553.96,,15071943,6956787135,,c8e825f928c94a8690be935a71905ade,a759163a6e324c30a067be90b37241e7,0.046,24/01/2023 22:17
04/02/2023 14:27,4,PLN,200,"37,9",PAY,RECEIVED,APPROVED,EUR,"1,79",EUR,3530.28,,15071851,6956740225,,5eacc5fbc145457eb2fda463f4de63ba,a759163a6e324c30a067be90b37241e7,0.199,24/01/2023 22:08
04/02/2023 14:21,4,EUR,135,"130,11",PAY,RECEIVED,APPROVED,EUR,"4,89",EUR,3492.38,,2073569,1382902427,Payout description,600bb0e2c56544eb9b4cfdeed189a218,a759163a6e324c30a067be90b37241e7,0.052,24/01/2023 22:06
04/02/2023 14:06,4,PLN,71,"13,13",PAY,RECEIVED,APPROVED,EUR,"0,96",EUR,3362.27,,2073566,1382900355,Payout description,2003692279bb403988eaf263882b40a7,a759163a6e324c30a067be90b37241e7,0.052,24/01/2023 22:06
04/02/2023 13:51,4,PLN,200,"-45,81",PAYOUT,SENT,APPROVED,EUR,"0,95",EUR,3349.14,,15071327,6956498597,,30d2700ba70741899b6247b628f2ebd7,a759163a6e324c30a067be90b37241e7,0.199,24/01/2023 21:16
04/02/2023 13:39,4,PLN,54,"9,86",PAY,RECEIVED,APPROVED,EUR,"0,85",EUR,3394.95,,15071244,6956458057,,e21defea37714eb2a1e77910fc5d457d,a759163a6e324c30a067be90b37241e7,0.199,24/01/2023 21:08
04/02/2023 13:33,4,EUR,101,"97,21",PAY,RECEIVED,APPROVED,EUR,"3,79",EUR,3385.09,,15071028,6956329171,,913ea3e64b8646c6bfdfb70954d16877,a759163a6e324c30a067be90b37241e7,0.046,24/01/2023 20:45
04/02/2023 13:06,4,PLN,25,"4,29",PAY,RECEIVED,APPROVED,EUR,"0,67",EUR,3287.88,,15070840,6956219427,,826e7a8dcb484fe4a37a89d2127cbc81,a759163a6e324c30a067be90b37241e7,0.199,24/01/2023 20:29
04/02/2023 13:06,4,TRY,895,"-47,77",PAYOUT,SENT,APPROVED,EUR,"0,97",EUR,3283.59,,15070671,6956126549,,dd4691a281564c2290d6768a5f0f2ac7,a759163a6e324c30a067be90b37241e7,0.199,24/01/2023 20:14
04/02/2023 13:04,4,PLN,790,"151,19",PAY,RECEIVED,APPROVED,EUR,"5,6",EUR,3331.36,,15070593,6956085217,,ddf3b953cbea4fdcbc6639048d2b40cd,a759163a6e324c30a067be90b37241e7,0.199,24/01/2023 20:08
04/02/2023 12:26,4,TRY,750,"32,96",PAY,RECEIVED,APPROVED,EUR,"1,63",EUR,3180.17,,15070527,6956039067,,854ae5fecbac45bcb885392775af2beb,a759163a6e324c30a067be90b37241e7,,24/01/2023 20:00
04/02/2023 11:58,4,TRY,880,"38,76",PAY,RECEIVED,APPROVED,EUR,"1,82",EUR,3147.21,,2073069,1382737163,Payout description,81149bb32f1c46fe979b822bdde50cd0,a759163a6e324c30a067be90b37241e7,0.052,24/01/2023 19:36
04/02/2023 11:27,4,TRY,592,"25,91",PAY,RECEIVED,APPROVED,EUR,"1,39",EUR,3108.45,,15070011,6955671455,,d7669a401ee84e8a8026b231be1bc108,a759163a6e324c30a067be90b37241e7,0.199,24/01/2023 19:16
04/02/2023 11:16,4,TRY,500,"21,81",PAY,RECEIVED,APPROVED,EUR,"1,25",EUR,3082.54,,15069930,6955606817,,d40609c55a674241973f15f0f65e65a2,a759163a6e324c30a067be90b37241e7,0.046,24/01/2023 19:08
04/02/2023 10:51,4,PLN,200,"-45,81",PAYOUT,SENT,APPROVED,EUR,"0,95",EUR,3060.73,,2072970,1382681037,Payout description,4c94ff7ebe6144b9b759400ef143b992,a759163a6e324c30a067be90b37241e7,0.052,24/01/2023 19:06
04/02/2023 10:50,4,PLN,25,"4,29",PAY,RECEIVED,APPROVED,EUR,"0,67",EUR,3106.54,,15069810,6955493979,,b320f9cd5ac34472905950c8ad2cb9d4,a759163a6e324c30a067be90b37241e7,0.046,24/01/2023 18:58
04/02/2023 10:26,4,PLN,50,"9,09",PAY,RECEIVED,APPROVED,EUR,"0,83",EUR,3102.25,,15069732,6955441077,,f7fce2d95f6a41efa516811beca25af8,a759163a6e324c30a067be90b37241e7,0.046,24/01/2023 18:53
04/02/2023 10:15,4,TRY,900,"39,66",PAY,RECEIVED,APPROVED,EUR,"1,85",EUR,3093.16,,15069012,6954857207,,c1fa7975ef3b498da62e77dea11da592,a759163a6e324c30a067be90b37241e7,,24/01/2023 17:52
04/02/2023 10:13,4,TRY,50,"1,72",PAY,RECEIVED,APPROVED,EUR,"0,58",EUR,3053.50,,2072741,1382558853,Payout description,5e2b8a082b6548d082821a5eabb49301,a759163a6e324c30a067be90b37241e7,0.225,24/01/2023 17:36
04/02/2023 9:49,4,PLN,100,"18,69",PAY,RECEIVED,APPROVED,EUR,"1,15",EUR,3051.78,,15068752,6954671341,,03537f5d81a84df7870fc602a594d0b1,a759163a6e324c30a067be90b37241e7,0.046,24/01/2023 17:25
04/02/2023 9:43,4,PLN,50,"9,09",PAY,RECEIVED,APPROVED,EUR,"0,83",EUR,3033.09,,2072706,1382529921,Payout description,d3bccee9428a4c58ac8ff109d58bcf44,a759163a6e324c30a067be90b37241e7,0.052,24/01/2023 17:21
04/02/2023 9:39,4,PLN,30,"5,25",PAY,RECEIVED,APPROVED,EUR,"0,7",EUR,3024.00,,2072678,1382530251,Payout description,b9d482ff5bd64abb988e69311e9a0977,a759163a6e324c30a067be90b37241e7,0.225,24/01/2023 17:06
04/02/2023 9:35,4,PLN,20,"3,33",PAY,RECEIVED,APPROVED,EUR,"0,63",EUR,3018.75,,15068414,6954444473,,90388c75619945efa9137bb5b7568e0a,a759163a6e324c30a067be90b37241e7,0.046,24/01/2023 16:56
04/02/2023 9:06,4,TRY,875,"-46,71",PAYOUT,SENT,APPROVED,EUR,"0,96",EUR,3015.42,,2072606,1382481507,Payout description,340a4fd237764111a535eee74b4df4c4,a759163a6e324c30a067be90b37241e7,0.052,24/01/2023 16:36
04/02/2023 8:53,4,TRY,300,"12,88",PAY,RECEIVED,APPROVED,EUR,"0,95",EUR,3062.13,,15068142,6954250797,,368b85e3a2bf4e419bd61c99edbc4386,a759163a6e324c30a067be90b37241e7,0.199,24/01/2023 16:29
04/02/2023 8:51,4,EUR,25,"23,68",PAY,RECEIVED,APPROVED,EUR,"1,32",EUR,3049.25,,15068085,6954206083,,c7bfd44e905e49b7901e0d33ac07027c,a759163a6e324c30a067be90b37241e7,0.199,24/01/2023 16:23
04/02/2023 8:49,4,EUR,20,"18,85",PAY,RECEIVED,APPROVED,EUR,"1,15",EUR,3025.57,,15067794,6954018051,,86d3fba5119c4c6582ee7af73632c52a,a759163a6e324c30a067be90b37241e7,,24/01/2023 15:59
04/02/2023 8:45,4,EUR,"100,52","96,75",PAY,RECEIVED,APPROVED,EUR,"3,77",EUR,3006.72,,15067763,6953996487,,55018842f4b04d0da11b941d436810ff,a759163a6e324c30a067be90b37241e7,0.046,24/01/2023 15:56
04/02/2023 8:41,4,EUR,10,"9,17",PAY,RECEIVED,APPROVED,EUR,"0,83",EUR,2909.97,,15067656,6953913435,,88f23b9299f3403984718a3786c6870e,a759163a6e324c30a067be90b37241e7,,24/01/2023 15:46
04/02/2023 8:37,4,TRY,422,"18,32",PAY,RECEIVED,APPROVED,EUR,"1,14",EUR,2900.80,,2072348,1382358301,Payout description,86a234944b52477d91d156fada168023,a759163a6e324c30a067be90b37241e7,0.052,24/01/2023 14:51
04/02/2023 8:33,4,TRY,2564,"113,91",PAY,RECEIVED,APPROVED,EUR,"4,35",EUR,2882.48,,15066946,6953372167,,ff441d8e219740b6898bc06ac16783bc,a759163a6e324c30a067be90b37241e7,0.2,24/01/2023 14:34
04/02/2023 8:33,4,EUR,5,"4,33",PAY,RECEIVED,APPROVED,EUR,"0,67",EUR,2768.57,,15066490,6952987037,,d152a5553bcc4a86a2cba4252f399e60,a759163a6e324c30a067be90b37241e7,,24/01/2023 13:42
04/02/2023 8:21,4,PLN,200,"-45,81",PAYOUT,SENT,APPROVED,EUR,"0,95",EUR,2764.24,,15066477,6952976009,,8da5ffcc49a542f69a8c83f8001d7b70,a759163a6e324c30a067be90b37241e7,0.046,24/01/2023 13:40
04/02/2023 8:20,4,EUR,135,"130,11",PAY,RECEIVED,APPROVED,EUR,"4,89",EUR,2810.05,,15066336,6952860401,,3301c1351f0941f5b74d26df2e1a1f46,a759163a6e324c30a067be90b37241e7,,24/01/2023 13:25
04/02/2023 7:46,4,PLN,32,"5,64",PAY,RECEIVED,APPROVED,EUR,"0,71",EUR,2679.94,,15066189,6952729487,,5b04be0f33224da299feafbe182a934f,a759163a6e324c30a067be90b37241e7,0.046,24/01/2023 13:05
04/02/2023 7:36,4,EUR,20,"-20,7",PAYOUT,SENT,APPROVED,EUR,"0,7",EUR,2674.30,,15066089,6952671751,,03415bb5550e4e068b43eadb96eac9ad,a759163a6e324c30a067be90b37241e7,0.046,24/01/2023 12:59
04/02/2023 7:32,4,PLN,20,"3,33",PAY,RECEIVED,APPROVED,EUR,"0,63",EUR,2695.00,,15066032,6952636251,,648ce0df30c249fd916fa43a5b903eb5,a759163a6e324c30a067be90b37241e7,,24/01/2023 12:52
04/02/2023 7:12,4,EUR,150,"144,62",PAY,RECEIVED,APPROVED,EUR,"5,38",EUR,2691.67,,15065760,6952429093,,cc92c43ef8bc4f81b41143453292b0b1,a759163a6e324c30a067be90b37241e7,0.199,24/01/2023 12:23
04/02/2023 7:06,4,EUR,240,"-242,9",PAYOUT,SENT,APPROVED,EUR,"2,9",EUR,2547.05,,2071983,1382175113,Payout description,59ce576f6ce948d4927ec97a18b4ac04,a759163a6e324c30a067be90b37241e7,0.044,24/01/2023 12:21
04/02/2023 6:26,4,EUR,10,"9,17",PAY,RECEIVED,APPROVED,EUR,"0,83",EUR,2789.95,,2071978,1382168043,Payout description,436383b0b64b4e1dba706b9ec9cecabd,a759163a6e324c30a067be90b37241e7,0.044,24/01/2023 12:21
04/02/2023 6:21,4,TRY,1064,"46,97",PAY,RECEIVED,APPROVED,EUR,"2,1",EUR,2780.78,,2071952,1382158747,Payout description,e84d32bc91704e68806a4c8b5c4adf18,a759163a6e324c30a067be90b37241e7,0.044,24/01/2023 12:06
04/02/2023 6:02,4,EUR,25,"23,68",PAY,RECEIVED,APPROVED,EUR,"1,32",EUR,2733.81,,2071946,1382149329,Payout description,0e562b7698d74073bd3c7f796f690a35,a759163a6e324c30a067be90b37241e7,0.044,24/01/2023 12:06
04/02/2023 5:36,4,TRY,150,"-8,43",PAYOUT,SENT,APPROVED,EUR,"0,58",EUR,2710.13,,2071922,1382140909,Payout description,e0b3ac11126b4ad6a836ae80729e2023,a759163a6e324c30a067be90b37241e7,0.044,24/01/2023 11:51
04/02/2023 3:39,4,PLN,"73,27","13,56",PAY,RECEIVED,APPROVED,EUR,"0,98",EUR,2718.56,,15065458,6952192883,,b08f6ff797194cd483cb51052dfd38b1,a759163a6e324c30a067be90b37241e7,,24/01/2023 11:47
04/02/2023 2:26,4,PLN,20,"3,33",PAY,RECEIVED,APPROVED,EUR,"0,63",EUR,2705.00,,2071895,1382108323,Payout description,38b9ab62bcc143bea76b3c1a5b21b898,a759163a6e324c30a067be90b37241e7,0.044,24/01/2023 11:36
04/02/2023 1:21,4,TRY,250,"-13,72",PAYOUT,SENT,APPROVED,EUR,"0,64",EUR,2701.67,,15065275,6952052589,,c1fb51b6adb4404f881303c4d29be4aa,a759163a6e324c30a067be90b37241e7,0.039,24/01/2023 11:25
04/02/2023 1:06,4,PLN,31,"5,45",PAY,RECEIVED,APPROVED,EUR,"0,7",EUR,2715.39,,15065020,6951844533,,c975d838b144404996edbc07c0acc400,a759163a6e324c30a067be90b37241e7,,24/01/2023 10:50
04/02/2023 0:21,4,TRY,100,"-5,79",PAYOUT,SENT,APPROVED,EUR,"0,56",EUR,2709.94,,15064932,6951770117,,065ba235dc034007bc06a6931f7c0fc6,a759163a6e324c30a067be90b37241e7,0.046,24/01/2023 10:38
03/02/2023 23:58,3,PLN,10,"1,41",PAY,RECEIVED,APPROVED,EUR,"0,57",EUR,2715.73,,15064921,6951762223,,1c1b0af7930b4ba590856599b9bf0574,a759163a6e324c30a067be90b37241e7,0.046,24/01/2023 10:37
03/02/2023 23:33,3,TRY,43,"191,38",PAY,RECEIVED,APPROVED,EUR,"6,95",EUR,2714.32,,15064644,6951571795,,f414f99cdf3d4797a0e7f30e987825f9,a759163a6e324c30a067be90b37241e7,,24/01/2023 10:05
03/02/2023 23:21,3,TRY,795,"-420,3",PAYOUT,SENT,APPROVED,EUR,"4,66",EUR,2522.94,,15064642,6951571243,,3557521ff9034aa58ea2aed8f033ee45,a759163a6e324c30a067be90b37241e7,0.046,24/01/2023 10:05
03/02/2023 23:06,3,EUR,"185,19","-187,55",PAYOUT,SENT,APPROVED,EUR,"2,36",EUR,2943.24,,15064444,6951413787,,5117f00950c6464e89f762d27231af3b,a759163a6e324c30a067be90b37241e7,0.046,24/01/2023 9:37
03/02/2023 22:48,3,EUR,25,"23,68",PAY,RECEIVED,APPROVED,EUR,"1,32",EUR,3130.79,,15064387,6951386363,,ac851b1366e141d7a1d756a1777eae0a,a759163a6e324c30a067be90b37241e7,0.046,24/01/2023 9:31
03/02/2023 22:40,3,SEK,5,"399,08",PAY,RECEIVED,APPROVED,EUR,"13,93",EUR,3107.11,,15064340,6951358827,,e2d42c519a0d40668bcbe33f15f93d92,a759163a6e324c30a067be90b37241e7,0.046,24/01/2023 9:26
03/02/2023 22:36,3,TRY,100,"3,96",PAY,RECEIVED,APPROVED,EUR,"0,65",EUR,2708.03,,2071561,1381946135,Payout description,7246d6ac412e485a926f968c86fca2a5,a759163a6e324c30a067be90b37241e7,0.052,24/01/2023 9:21
03/02/2023 21:51,3,TRY,10,"-528,44",PAYOUT,SENT,APPROVED,EUR,"5,73",EUR,2704.07,,15064104,6951235159,,73d5f25e0e3944ccb62a1f056b697d2e,a759163a6e324c30a067be90b37241e7,,24/01/2023 9:01
03/02/2023 21:45,3,EUR,5,"4,33",PAY,RECEIVED,APPROVED,EUR,"0,67",EUR,3232.51,,15064015,6951157897,,694c61832064481a84d45e5ff20246cb,a759163a6e324c30a067be90b37241e7,0.046,24/01/2023 8:45
03/02/2023 21:38,3,PLN,70,"12,97",PAY,RECEIVED,APPROVED,EUR,"0,96",EUR,3228.18,,15063953,6951100481,,69b4eab48e624ea3914f9f4fbb45a1d1,a759163a6e324c30a067be90b37241e7,,24/01/2023 8:32
03/02/2023 21:35,3,SEK,51,"406,84",PAY,RECEIVED,APPROVED,EUR,"14,19",EUR,3215.21,,2071308,1381857665,Payout description,48328fb94d8440769c18743599d890a6,a759163a6e324c30a067be90b37241e7,0.052,24/01/2023 7:36
03/02/2023 21:32,3,EUR,15,"14,01",PAY,RECEIVED,APPROVED,EUR,"0,99",EUR,2808.37,,15063374,6950545173,,7dc1eac819c74e09b269742933362666,a759163a6e324c30a067be90b37241e7,0.046,24/01/2023 5:50
03/02/2023 21:25,3,EUR,15,"14,01",PAY,RECEIVED,APPROVED,EUR,"0,99",EUR,2794.36,,15063358,6950535299,,06eb3d9b1141417e914f8fd603025147,a759163a6e324c30a067be90b37241e7,,24/01/2023 5:46
03/02/2023 21:22,3,EUR,50,"47,87",PAY,RECEIVED,APPROVED,EUR,"2,13",EUR,2780.35,,2071141,1381760275,Payout description,882f8be6a66b4166949178d9abba9cb1,a759163a6e324c30a067be90b37241e7,0.225,24/01/2023 5:36
03/02/2023 21:06,3,TRY,"312,72","13,47",PAY,RECEIVED,APPROVED,EUR,"0,97",EUR,2732.48,,2071140,1381759905,Payout description,9dad31b58f174ddfb25a59de3c18ac6e,a759163a6e324c30a067be90b37241e7,,24/01/2023 5:36
03/02/2023 21:06,3,TRY,8525,"380,42",PAY,RECEIVED,APPROVED,EUR,"13,3",EUR,2719.01,,15063327,6950506613,,ee980e896e4342da8ddc9f6044cef96c,a759163a6e324c30a067be90b37241e7,,24/01/2023 5:35
03/02/2023 21:05,3,TRY,2941,"130,91",PAY,RECEIVED,APPROVED,EUR,"4,92",EUR,2338.59,,2071120,1381748119,Payout description,917cd0f871ea4faeb0a8796bfb249a62,a759163a6e324c30a067be90b37241e7,0.052,24/01/2023 5:21
03/02/2023 20:58,3,TRY,3085,"137,44",PAY,RECEIVED,APPROVED,EUR,"5,14",EUR,2207.68,,15063146,6950386155,,46a158c632c94d75906d70c615d36548,a759163a6e324c30a067be90b37241e7,,24/01/2023 4:38
03/02/2023 20:52,3,PLN,15,"2,38",PAY,RECEIVED,APPROVED,EUR,"0,6",EUR,2070.24,,15062402,6949933001,,46ddcab7d97147ab858e2ecb53272669,a759163a6e324c30a067be90b37241e7,0.046,24/01/2023 0:12
03/02/2023 20:51,3,PLN,200,"-45,94",PAYOUT,SENT,APPROVED,EUR,"0,95",EUR,2067.86,,15062231,6949841281,,4d312d78b7884802964ade043e0d3838,a759163a6e324c30a067be90b37241e7,,23/01/2023 23:36
03/02/2023 20:32,3,PLN,25,"4,31",PAY,RECEIVED,APPROVED,EUR,"0,67",EUR,2113.80,,15062131,6949792499,,10afc6d59a2f4be8bd91940d5d2cb664,a759163a6e324c30a067be90b37241e7,0.084,23/01/2023 23:21
03/02/2023 19:54,3,PLN,10,"1,42",PAY,RECEIVED,APPROVED,EUR,"0,57",EUR,2109.49,,15061992,6949725583,,2dfae3d6a58b4d7eacdba84ce1f52db5,a759163a6e324c30a067be90b37241e7,,23/01/2023 22:59
03/02/2023 19:47,3,PLN,10,"1,42",PAY,RECEIVED,APPROVED,EUR,"0,57",EUR,2108.07,,15061744,6949601149,,187437f12b8247f3a85b276e3ead3a06,a759163a6e324c30a067be90b37241e7,0.046,23/01/2023 22:26
03/02/2023 19:41,3,EUR,5,"4,33",PAY,RECEIVED,APPROVED,EUR,"0,67",EUR,2106.65,,2070539,1381444559,Payout description,70c732748374473196c503f674fffcbe,a759163a6e324c30a067be90b37241e7,0.052,23/01/2023 21:51
03/02/2023 19:26,3,EUR,10,"9,17",PAY,RECEIVED,APPROVED,EUR,"0,83",EUR,2102.32,,15060999,6949259855,,9c7f67c2ebd24ba18d52c89882f99f1e,a759163a6e324c30a067be90b37241e7,,23/01/2023 21:15
03/02/2023 19:23,3,TRY,100,"3,96",PAY,RECEIVED,APPROVED,EUR,"0,65",EUR,2093.15,,15060809,6949144795,,f19714597f0f42c0b1f543d3fd6b2ae9,a759163a6e324c30a067be90b37241e7,0.046,23/01/2023 20:53
03/02/2023 18:56,3,TRY,1382,"61,2",PAY,RECEIVED,APPROVED,EUR,"2,58",EUR,2089.19,,2070307,1381363069,Payout description,ebfc247a70af4081a2d6dbe7aaed0b46,a759163a6e324c30a067be90b37241e7,0.052,23/01/2023 20:36
03/02/2023 18:41,3,EUR,"30,31","28,82",PAY,RECEIVED,APPROVED,EUR,"1,49",EUR,2027.99,,15060486,6948961077,,eedf35574b874fe4841f059d6a0af5d5,a759163a6e324c30a067be90b37241e7,,23/01/2023 20:22
03/02/2023 18:34,3,PLN,40,"7,21",PAY,RECEIVED,APPROVED,EUR,"0,76",EUR,1999.17,,2070189,1381315783,Payout description,6f25be8945d6438c8119ff5fa06401fa,a759163a6e324c30a067be90b37241e7,,23/01/2023 20:06
03/02/2023 18:05,3,PLN,10,"1,42",PAY,RECEIVED,APPROVED,EUR,"0,57",EUR,1991.96,,15059858,6948594787,,43d26240b0d14895b0df3c535340b14c,a759163a6e324c30a067be90b37241e7,,23/01/2023 19:32
03/02/2023 18:03,3,PLN,51,"9,33",PAY,RECEIVED,APPROVED,EUR,"0,84",EUR,1990.54,,15059839,6948584471,,02db7a86102946ad999110f19c22a972,a759163a6e324c30a067be90b37241e7,0.046,23/01/2023 19:30
03/02/2023 18:02,3,EUR,"51,03","48,87",PAY,RECEIVED,APPROVED,EUR,"2,16",EUR,1981.21,,15059821,6948578215,,eaa34ed68c4d4ede8fc2403808630e4f,a759163a6e324c30a067be90b37241e7,0.2,23/01/2023 19:28
03/02/2023 17:48,3,TRY,7,"311,42",PAY,RECEIVED,APPROVED,EUR,"10,98",EUR,1932.34,,15059747,6948532587,,e150bf7776a0409e90bf9c919d2f93b8,a759163a6e324c30a067be90b37241e7,0.2,23/01/2023 19:22
03/02/2023 17:43,3,PLN,10,"1,42",PAY,RECEIVED,APPROVED,EUR,"0,57",EUR,1620.92,,15059702,6948504847,,0c601c4dc0624c6bb438a464ca95175a,a759163a6e324c30a067be90b37241e7,0.2,23/01/2023 19:21
03/02/2023 17:38,3,EUR,1,"0,46",PAY,RECEIVED,APPROVED,EUR,"0,54",EUR,1619.50,,2069849,1381265493,Payout description,fe57099e761e4100a66bff61ca880db8,a759163a6e324c30a067be90b37241e7,0.052,23/01/2023 19:21
03/02/2023 17:35,3,EUR,6,"5,3",PAY,RECEIVED,APPROVED,EUR,"0,7",EUR,1619.04,,15059472,6948351323,,dbc35d74f3c748678816c8f4a39d3f54,a759163a6e324c30a067be90b37241e7,0.2,23/01/2023 18:58
03/02/2023 17:21,3,PLN,20,"3,36",PAY,RECEIVED,APPROVED,EUR,"0,63",EUR,1613.74,,15059397,6948300681,,6458517b91944b75b410c1a9fcbad1be,a759163a6e324c30a067be90b37241e7,0.046,23/01/2023 18:51
03/02/2023 17:21,3,TRY,20,"-1,57",PAYOUT,SENT,APPROVED,EUR,"0,52",EUR,1610.38,,15059392,6948294909,,32ac6b73cabb47cdba3db8ee57c60479,a759163a6e324c30a067be90b37241e7,0.046,23/01/2023 18:50
03/02/2023 17:20,3,EUR,10,"9,17",PAY,RECEIVED,APPROVED,EUR,"0,83",EUR,1611.95,,15059312,6948252787,,ed384a22a9a845b596246423c391bb21,a759163a6e324c30a067be90b37241e7,0.2,23/01/2023 18:45
03/02/2023 17:14,3,EUR,"27,13","25,74",PAY,RECEIVED,APPROVED,EUR,"1,39",EUR,1602.78,,2069623,1381197281,Payout description,c28e4e7512864080b0e3e65d7afd9369,a759163a6e324c30a067be90b37241e7,,23/01/2023 18:36
03/02/2023 16:06,3,TRY,100,"-5,75",PAYOUT,SENT,APPROVED,EUR,"0,56",EUR,1577.04,,15059092,6948129631,,a67e4c398b7948048417539d801bed88,a759163a6e324c30a067be90b37241e7,0.046,23/01/2023 18:26
03/02/2023 15:46,3,TRY,100,"3,94",PAY,RECEIVED,APPROVED,EUR,"0,65",EUR,1582.79,,15059080,6948122967,,4aaba957a012470fa00dafe2adff0341,a759163a6e324c30a067be90b37241e7,0.046,23/01/2023 18:25
03/02/2023 15:34,3,TRY,"186,45","7,79",PAY,RECEIVED,APPROVED,EUR,"0,78",EUR,1578.85,,15059066,6948115069,,130138f0d75a4db1b353a73b964e5939,a759163a6e324c30a067be90b37241e7,0.046,23/01/2023 18:24
03/02/2023 14:44,3,TRY,102,"4,02",PAY,RECEIVED,APPROVED,EUR,"0,66",EUR,1571.06,,15058996,6948077837,,37886227208c45e58f316564707025e1,a759163a6e324c30a067be90b37241e7,0.046,23/01/2023 18:18
03/02/2023 14:27,3,TRY,500,"21,75",PAY,RECEIVED,APPROVED,EUR,"1,25",EUR,1567.04,,15058980,6948071917,,4b0ff3a4f9854b12b1e19dd3c4999b0d,a759163a6e324c30a067be90b37241e7,0.046,23/01/2023 18:18
03/02/2023 14:23,3,TRY,10,"444,59",PAY,RECEIVED,APPROVED,EUR,"15,46",EUR,1545.29,,15058964,6948065253,,0cc1d91e5fe24e7b8b70f84d729e5b7a,a759163a6e324c30a067be90b37241e7,0.046,23/01/2023 18:17
03/02/2023 13:54,3,PLN,30,"5,3",PAY,RECEIVED,APPROVED,EUR,"0,7",EUR,1100.70,,15058674,6947940101,,67078e21dcc341da82bbffbb7fd8587e,a759163a6e324c30a067be90b37241e7,0.084,23/01/2023 17:58
03/02/2023 13:51,3,TRY,1486,"-78,56",PAYOUT,SENT,APPROVED,EUR,"1,28",EUR,1095.40,,15058536,6947858237,,d3d90bba8c014e8d95d287183cdc09e4,a759163a6e324c30a067be90b37241e7,0.046,23/01/2023 17:46
03/02/2023 13:47,3,EUR,90,"86,57",PAY,RECEIVED,APPROVED,EUR,"3,43",EUR,1173.96,,15058516,6947842753,,7014af548a1c4463974961d164effc00,a759163a6e324c30a067be90b37241e7,0.2,23/01/2023 17:44
03/02/2023 13:14,3,PLN,"10,5","1,53",PAY,RECEIVED,APPROVED,EUR,"0,57",EUR,1087.39,,15058489,6947827657,,f25f5316359240a8ba20382009f5081c,a759163a6e324c30a067be90b37241e7,,23/01/2023 17:42
03/02/2023 13:14,3,EUR,31,"29,49",PAY,RECEIVED,APPROVED,EUR,"1,51",EUR,1085.86,,2069493,1381115459,Payout description,926c7e726f08470aa2a1cc2709a9fb99,a759163a6e324c30a067be90b37241e7,0.052,23/01/2023 17:36
03/02/2023 13:14,3,TRY,5,"220,31",PAY,RECEIVED,APPROVED,EUR,"7,92",EUR,1056.37,,15058429,6947777541,,e52857945bb944c09948c2220c9a2ea4,a759163a6e324c30a067be90b37241e7,,23/01/2023 17:33
03/02/2023 13:14,3,EUR,200,193,PAY,RECEIVED,APPROVED,EUR,7,EUR,836.06,,15058251,6947659209,,6d87696d9b2644bca650f3873ee8a587,a759163a6e324c30a067be90b37241e7,0.2,23/01/2023 17:17
03/02/2023 12:51,3,EUR,99,"-100,49",PAYOUT,SENT,APPROVED,EUR,"1,49",EUR,643.06,,15058105,6947551485,,79c561440c93441fae2839df3df0b106,a759163a6e324c30a067be90b37241e7,0.2,23/01/2023 17:02
03/02/2023 12:48,3,PLN,"10,1","1,45",PAY,RECEIVED,APPROVED,EUR,"0,57",EUR,743.55,,15058033,6947517085,,0675eb80bc5f464aa74ad67d40ea4b19,a759163a6e324c30a067be90b37241e7,0.2,23/01/2023 16:57
03/02/2023 12:21,3,TRY,1,"43,7",PAY,RECEIVED,APPROVED,EUR,"1,99",EUR,742.10,,2069388,1381052551,Payout description,8c45681a54444ed2986bd1b762ddea7c,a759163a6e324c30a067be90b37241e7,0.225,23/01/2023 16:51
03/02/2023 12:00,3,EUR,10,"9,17",PAY,RECEIVED,APPROVED,EUR,"0,83",EUR,698.40,,15057636,6947289653,,e90897f367a043eb958bfc9f51d210f8,a759163a6e324c30a067be90b37241e7,0.2,23/01/2023 16:27
03/02/2023 11:33,3,EUR,30,"28,52",PAY,RECEIVED,APPROVED,EUR,"1,48",EUR,689.23,,15057533,6947211049,,d56a43edff6340e5a16ae746c2e9b7fc,a759163a6e324c30a067be90b37241e7,,23/01/2023 16:19
03/02/2023 11:15,3,EUR,25,"23,68",PAY,RECEIVED,APPROVED,EUR,"1,32",EUR,660.71,,15057344,6947087261,,82ae391132b249d6b8847dd9354ef648,a759163a6e324c30a067be90b37241e7,0.046,23/01/2023 16:00
03/02/2023 11:06,3,EUR,10,"9,17",PAY,RECEIVED,APPROVED,EUR,"0,83",EUR,637.03,,15057289,6947044091,,5462a40485c843d98979a0a5e3335dc6,a759163a6e324c30a067be90b37241e7,0.046,23/01/2023 15:54
03/02/2023 10:21,3,EUR,50,-51,PAYOUT,SENT,APPROVED,EUR,1,EUR,627.86,,15057050,6946874707,,0456d386f0d8469b8d3441f3faa42889,a759163a6e324c30a067be90b37241e7,0.046,23/01/2023 15:30
03/02/2023 10:01,3,EUR,"101,51","97,71",PAY,RECEIVED,APPROVED,EUR,"3,8",EUR,678.86,,15056960,6946820655,,739372bdff704cef9897a384fa0cb5ab,a759163a6e324c30a067be90b37241e7,,23/01/2023 15:23
03/02/2023 10:00,3,TRY,146,"63,99",PAY,RECEIVED,APPROVED,EUR,"2,67",EUR,581.15,,15056939,6946805593,,f62b55f3a0064f99b1659c7ed9f59db1,a759163a6e324c30a067be90b37241e7,,23/01/2023 15:22
03/02/2023 9:15,3,TRY,100,"3,92",PAY,RECEIVED,APPROVED,EUR,"0,65",EUR,517.16,,2069156,1380927887,Payout description,085338048cad4888af248bd08d70e4fa,a759163a6e324c30a067be90b37241e7,0.052,23/01/2023 15:21
03/02/2023 8:41,3,EUR,10,"9,17",PAY,RECEIVED,APPROVED,EUR,"0,83",EUR,513.24,,15056860,6946747493,,de39c254c320492ebc406dcad0ec9a7d,a759163a6e324c30a067be90b37241e7,,23/01/2023 15:12
03/02/2023 8:36,3,EUR,25,"23,68",PAY,RECEIVED,APPROVED,EUR,"1,32",EUR,504.07,,15056761,6946681059,,75997b9758434eb8b572af916e7cc3a8,a759163a6e324c30a067be90b37241e7,,23/01/2023 15:05
03/02/2023 8:34,3,PLN,25,"4,33",PAY,RECEIVED,APPROVED,EUR,"0,67",EUR,480.39,,15056647,6946598233,,5314e87d2e0742baa55d022a70edc22f,a759163a6e324c30a067be90b37241e7,,23/01/2023 14:52
03/02/2023 8:07,3,PLN,60,"11,13",PAY,RECEIVED,APPROVED,EUR,"0,9",EUR,476.06,,15056608,6946568449,,6e4a7d57a60c430a8004ed15f1d5fe20,a759163a6e324c30a067be90b37241e7,,23/01/2023 14:48
03/02/2023 8:03,3,PLN,"14,8","2,36",PAY,RECEIVED,APPROVED,EUR,"0,6",EUR,464.93,,15056606,6946566849,,63ceda34b09944d091142b8b31ef4353,a759163a6e324c30a067be90b37241e7,,23/01/2023 14:47
03/02/2023 7:56,3,PLN,9,"1,24",PAY,RECEIVED,APPROVED,EUR,"0,56",EUR,462.57,,15056440,6946465529,,69e2256acd5342e098a36527a12f4e51,a759163a6e324c30a067be90b37241e7,,23/01/2023 14:33
03/02/2023 7:51,3,PLN,5,"0,46",PAY,RECEIVED,APPROVED,EUR,"0,54",EUR,461.33,,15056389,6946433533,,6a5590ae0d104251a85abe41974cfadb,a759163a6e324c30a067be90b37241e7,0.046,23/01/2023 14:28
03/02/2023 6:40,3,EUR,"1,01","0,47",PAY,RECEIVED,APPROVED,EUR,"0,54",EUR,460.87,,2068965,1380810327,Payout description,aea0c004cab740d283357559065523c1,a759163a6e324c30a067be90b37241e7,0.052,23/01/2023 14:06
03/02/2023 6:33,3,TRY,410,"17,66",PAY,RECEIVED,APPROVED,EUR,"1,12",EUR,460.40,,15056173,6946273145,,df21cd845b6342d6bd6c9b30142683e3,a759163a6e324c30a067be90b37241e7,,23/01/2023 14:04
03/02/2023 2:18,3,PLN,100,"18,88",PAY,RECEIVED,APPROVED,EUR,"1,16",EUR,442.74,,15055990,6946128103,,8f9d5623a264448fbb460b5dd2123814,a759163a6e324c30a067be90b37241e7,,23/01/2023 13:43
03/02/2023 1:49,3,PLN,100,"18,88",PAY,RECEIVED,APPROVED,EUR,"1,16",EUR,423.86,,15055976,6946117707,,29ce37718f38431181b4216124c0d5d0,a759163a6e324c30a067be90b37241e7,0.046,23/01/2023 13:40
03/02/2023 0:39,3,PLN,12,"18,88",PAY,RECEIVED,APPROVED,EUR,"1,16",EUR,404.98,,15055883,6946039375,,871a0d0bde7c4711bf1d43befc7066f7,a759163a6e324c30a067be90b37241e7,,23/01/2023 13:31
02/02/2023 23:55,2,TRY,10,"52,62",PAY,RECEIVED,APPROVED,EUR,"2,29",EUR,386.10,,15055881,6946037839,,9627f58a1c834cfda0289ae381fcf3ef,a759163a6e324c30a067be90b37241e7,,23/01/2023 13:29
02/02/2023 23:36,2,TRY,1,"-522,01",PAYOUT,SENT,APPROVED,EUR,"5,67",EUR,333.48,,2068887,1380745421,Payout description,578a90aec623495b868edc3e6f1379ff,a759163a6e324c30a067be90b37241e7,0.052,23/01/2023 13:21
02/02/2023 23:36,2,PLN,1,"-229,41",PAYOUT,SENT,APPROVED,EUR,"2,77",EUR,855.49,,15055635,6945850667,,75ea1813c102439fb31d97875be52a37,a759163a6e324c30a067be90b37241e7,,23/01/2023 13:01
02/02/2023 23:36,2,PLN,15,"-229,41",PAYOUT,SENT,APPROVED,EUR,"2,77",EUR,1084.90,,15055605,6945815885,,3035158801244f7699fe654a7ed71f51,a759163a6e324c30a067be90b37241e7,0.084,23/01/2023 12:54
02/02/2023 22:44,2,PLN,141,"2,4",PAY,RECEIVED,APPROVED,EUR,"0,6",EUR,1314.31,,15055533,6945752851,,057849d5019e45b0a8efdbb50aa79a4e,a759163a6e324c30a067be90b37241e7,,23/01/2023 12:44
02/02/2023 22:25,2,PLN,50,"26,83",PAY,RECEIVED,APPROVED,EUR,"1,42",EUR,1311.91,,15055381,6945640947,,eae393e259a54ce5926b6198fc05a327,a759163a6e324c30a067be90b37241e7,0.199,23/01/2023 12:33
02/02/2023 22:11,2,EUR,52,"47,87",PAY,RECEIVED,APPROVED,EUR,"2,13",EUR,1285.08,,15055051,6945369141,,e0244ef749e44ce8bf95b716ea255a3f,a759163a6e324c30a067be90b37241e7,0.046,23/01/2023 11:41
02/02/2023 22:06,2,EUR,50,"-53,02",PAYOUT,SENT,APPROVED,EUR,"1,02",EUR,1237.21,,15054965,6945299287,,fc9ef1680dad462d9e4d3e8ead49b362,a759163a6e324c30a067be90b37241e7,,23/01/2023 11:28
02/02/2023 21:42,2,PLN,100,"9,19",PAY,RECEIVED,APPROVED,EUR,"0,83",EUR,1290.23,,15054737,6945123133,,562d80cf701a4daebb546744f3223118,a759163a6e324c30a067be90b37241e7,,23/01/2023 10:57
02/02/2023 21:36,2,PLN,10,"-23,35",PAYOUT,SENT,APPROVED,EUR,"0,73",EUR,1281.04,,15054683,6945088385,,5000681de0164697abd01e9e67888ded,a759163a6e324c30a067be90b37241e7,,23/01/2023 10:50
02/02/2023 21:20,2,EUR,10,"9,17",PAY,RECEIVED,APPROVED,EUR,"0,83",EUR,1304.39,,15054612,6945049737,,70f25167d0f14e209c74a2ce7eb6ea0d,a759163a6e324c30a067be90b37241e7,0.199,23/01/2023 10:41
02/02/2023 20:51,2,TRY,210,"-522,47",PAYOUT,SENT,APPROVED,EUR,"5,67",EUR,1295.22,,15054401,6944887991,,0efbcd1f9dc14db881e7eea042be10e9,a759163a6e324c30a067be90b37241e7,0.046,23/01/2023 10:08
02/02/2023 20:36,2,TRY,15,"-11,47",PAYOUT,SENT,APPROVED,EUR,"0,61",EUR,1817.69,,15054377,6944875941,,45c745b7277646f49dd34978c7d76d93,a759163a6e324c30a067be90b37241e7,0.007,23/01/2023 10:08
02/02/2023 20:12,2,EUR,20,"14,01",PAY,RECEIVED,APPROVED,EUR,"0,99",EUR,1829.16,,15054124,6944715639,,6340bdf9db4c4ae7a88533db01ca5e24,a759163a6e324c30a067be90b37241e7,0.199,23/01/2023 9:31
02/02/2023 20:10,2,PLN,165,"3,37",PAY,RECEIVED,APPROVED,EUR,"0,63",EUR,1815.15,,15054105,6944703351,,b015f6f298fe4f83a7aeb680965d1b0a,a759163a6e324c30a067be90b37241e7,0.199,23/01/2023 9:28
02/02/2023 20:04,2,EUR,10,"159,13",PAY,RECEIVED,APPROVED,EUR,"5,87",EUR,1811.78,,15054060,6944678393,,a48998780e824da3905dbe9d810807a1,a759163a6e324c30a067be90b37241e7,,23/01/2023 9:23
02/02/2023 19:57,2,SEK,200,"802,95",PAY,RECEIVED,APPROVED,EUR,"27,49",EUR,1652.65,,2068229,1380389815,Payout description,bb73c0aacbea4d02ac994a7b1178ddb2,a759163a6e324c30a067be90b37241e7,,23/01/2023 9:21
02/02/2023 19:51,2,EUR,3,"-202,5",PAYOUT,SENT,APPROVED,EUR,"2,5",EUR,849.70,,15054029,6944653915,,747cd693eb1c4853860b702937d6bfa7,a759163a6e324c30a067be90b37241e7,0.046,23/01/2023 9:18
02/02/2023 19:36,2,TRY,10,"-157,16",PAYOUT,SENT,APPROVED,EUR,"2,06",EUR,1052.20,,2068200,1380380595,Payout description,31ee7fa7ce6246f896b0b9e10acf6be2,a759163a6e324c30a067be90b37241e7,,23/01/2023 9:06
02/02/2023 19:25,2,EUR,10,"9,17",PAY,RECEIVED,APPROVED,EUR,"0,83",EUR,1209.36,,2068195,1380371199,Payout description,25d257c2d0cf4585ae69dd3995919cf9,a759163a6e324c30a067be90b37241e7,,23/01/2023 9:06
02/02/2023 19:21,2,TRY,50,"-522,12",PAYOUT,SENT,APPROVED,EUR,"5,67",EUR,1200.19,,15053657,6944387833,,ac9473e882544327ac98e38e21779b3c,a759163a6e324c30a067be90b37241e7,,23/01/2023 8:13
02/02/2023 18:59,2,EUR,250,"47,87",PAY,RECEIVED,APPROVED,EUR,"2,13",EUR,1722.31,,15053637,6944376029,,62b36ad3833f46989bf6b9a57392a721,a759163a6e324c30a067be90b37241e7,,23/01/2023 8:09
02/02/2023 18:06,2,EUR,2,-253,PAYOUT,SENT,APPROVED,EUR,3,EUR,1674.44,,15053574,6944336623,,4b68d5ee51d14076b62a6b656a1c7f0d,a759163a6e324c30a067be90b37241e7,0.046,23/01/2023 7:58
02/02/2023 17:14,2,TRY,101,"87,91",PAY,RECEIVED,APPROVED,EUR,"3,48",EUR,1927.44,,15053564,6944327677,,c7061fb281884aeeba924540cebb9b5a,a759163a6e324c30a067be90b37241e7,0.199,23/01/2023 7:55
02/02/2023 17:04,2,TRY,37,"3,96",PAY,RECEIVED,APPROVED,EUR,"0,65",EUR,1839.53,,2068020,1380295495,Payout description,646f6a5b888d48b6b4834b44b0a0e5e7,a759163a6e324c30a067be90b37241e7,,23/01/2023 7:51
02/02/2023 16:36,2,TRY,250,"-193,32",PAYOUT,SENT,APPROVED,EUR,"2,41",EUR,1835.57,,15053524,6944292967,,1fd649af48a84900a252c4fae6ee4ab4,a759163a6e324c30a067be90b37241e7,0.2,23/01/2023 7:47
02/02/2023 16:25,2,TRY,50,"10,53",PAY,RECEIVED,APPROVED,EUR,"0,88",EUR,2028.89,,15053503,6944272465,,df6ee35f4ac44c76b090022331672966,a759163a6e324c30a067be90b37241e7,0.046,23/01/2023 7:40
02/02/2023 16:00,2,EUR,11,"47,87",PAY,RECEIVED,APPROVED,EUR,"2,13",EUR,2018.36,,15053303,6944130323,,3be1c717839f4907b29ba617d985d43b,a759163a6e324c30a067be90b37241e7,,23/01/2023 6:54
02/02/2023 15:48,2,EUR,"151,51","10,14",PAY,RECEIVED,APPROVED,EUR,"0,86",EUR,1970.49,,15053033,6943920745,,43f0981007fc4ba296bd29b6aac12efc,a759163a6e324c30a067be90b37241e7,0.199,23/01/2023 5:27
02/02/2023 15:43,2,EUR,"6,57","146,08",PAY,RECEIVED,APPROVED,EUR,"5,43",EUR,1960.35,,15053011,6943901907,,d4380fd5aae348be99745c1ee50abc02,a759163a6e324c30a067be90b37241e7,0.199,23/01/2023 5:17
02/02/2023 15:39,2,EUR,51,"5,85",PAY,RECEIVED,APPROVED,EUR,"0,72",EUR,1814.27,,15052585,6943616737,,f5a344a183814b848785014d98504e40,a759163a6e324c30a067be90b37241e7,0.046,23/01/2023 2:04
02/02/2023 15:27,2,TRY,30,"1,75",PAY,RECEIVED,APPROVED,EUR,"0,58",EUR,1808.42,,15052329,6943502201,,fdce1b52611d4e029fe310c906953045,a759163a6e324c30a067be90b37241e7,0.046,23/01/2023 0:46
02/02/2023 15:18,2,EUR,50,"28,52",PAY,RECEIVED,APPROVED,EUR,"1,48",EUR,1806.67,,15052265,6943478113,,af6b026dc26b45f28e7a27c3813d4924,a759163a6e324c30a067be90b37241e7,0.2,23/01/2023 0:31
02/02/2023 15:05,2,EUR,10,"47,87",PAY,RECEIVED,APPROVED,EUR,"2,13",EUR,1778.15,,15052188,6943438535,,d33e1ede530345e0b8e67c732f1c93f5,a759163a6e324c30a067be90b37241e7,,23/01/2023 0:10
02/02/2023 14:59,2,EUR,8,"9,17",PAY,RECEIVED,APPROVED,EUR,"0,83",EUR,1730.28,,15051987,6943350861,,abf5a0cece694888821b79d86618f49c,a759163a6e324c30a067be90b37241e7,,22/01/2023 23:31
02/02/2023 14:26,2,PLN,15,"1,04",PAY,RECEIVED,APPROVED,EUR,"0,56",EUR,1721.11,,15051915,6943320735,,844a450c24734375967dd37f57c9d262,a759163a6e324c30a067be90b37241e7,,22/01/2023 23:19
02/02/2023 14:26,2,EUR,4,"14,01",PAY,RECEIVED,APPROVED,EUR,"0,99",EUR,1720.07,,15051746,6943242609,,60f3aa646509414eb7590e72e5be65f1,a759163a6e324c30a067be90b37241e7,0.046,22/01/2023 22:51
02/02/2023 13:32,2,EUR,240,"3,37",PAY,RECEIVED,APPROVED,EUR,"0,63",EUR,1706.06,,15051738,6943238063,,0ba7be5967e9448894cc4c613ed0a2ce,a759163a6e324c30a067be90b37241e7,,22/01/2023 22:50
02/02/2023 13:21,2,TRY,10,"-12,95",PAYOUT,SENT,APPROVED,EUR,"0,63",EUR,1702.69,,2067157,1379662603,Payout description,1292a1c604c54099998686ed204d00d8,a759163a6e324c30a067be90b37241e7,,22/01/2023 22:21
02/02/2023 13:20,2,TRY,850,"439,46",PAY,RECEIVED,APPROVED,EUR,"15,28",EUR,1715.64,,2067109,1379591669,Payout description,fb0d83f0f464465bac5af57ee5a55468,a759163a6e324c30a067be90b37241e7,0.226,22/01/2023 22:06
02/02/2023 12:46,2,TRY,100,"36,84",PAY,RECEIVED,APPROVED,EUR,"1,76",EUR,1276.18,,2066890,1379550299,Payout description,ac7b34dec7074d9b8fd69efad17fcfa4,a759163a6e324c30a067be90b37241e7,0.044,22/01/2023 21:36
02/02/2023 11:59,2,TRY,10,"3,88",PAY,RECEIVED,APPROVED,EUR,"0,65",EUR,1239.34,,15051112,6942927365,,09c2505b903949b590242686df999885,a759163a6e324c30a067be90b37241e7,0.046,22/01/2023 21:35
02/02/2023 11:15,2,EUR,100,"9,17",PAY,RECEIVED,APPROVED,EUR,"0,83",EUR,1235.46,,15050961,6942867863,,0d1a440b9fd24312abaccc361c4b7d6b,a759163a6e324c30a067be90b37241e7,,22/01/2023 21:20
02/02/2023 11:07,2,PLN,295,"18,81",PAY,RECEIVED,APPROVED,EUR,"1,15",EUR,1226.29,,15050938,6942858295,,14172b34708e48eeab936b8b28b00410,a759163a6e324c30a067be90b37241e7,0.046,22/01/2023 21:17
02/02/2023 10:35,2,EUR,"150,52","284,91",PAY,RECEIVED,APPROVED,EUR,"10,09",EUR,1207.48,,15050935,6942857415,,835719a1ae7949d8bd7dd1200608ec6f,a759163a6e324c30a067be90b37241e7,0.046,22/01/2023 21:17
02/02/2023 10:34,2,EUR,60,"145,12",PAY,RECEIVED,APPROVED,EUR,"5,4",EUR,922.57,,15050830,6942812245,,7b4bf49c485742fc8ba5b2f51e983bdd,a759163a6e324c30a067be90b37241e7,,22/01/2023 21:07
02/02/2023 10:32,2,EUR,397,"57,55",PAY,RECEIVED,APPROVED,EUR,"2,45",EUR,777.45,,2066814,1379503645,Payout description,d79835c24b974390be9797f5afbd4de9,a759163a6e324c30a067be90b37241e7,0.052,22/01/2023 21:06
02/02/2023 10:21,2,PLN,"3,15","-90,8",PAYOUT,SENT,APPROVED,EUR,"1,4",EUR,719.90,,15050562,6942670687,,5610150f00e74fa49430ab2ec714a54b,a759163a6e324c30a067be90b37241e7,0.046,22/01/2023 20:36
02/02/2023 9:13,2,EUR,40,"2,54",PAY,RECEIVED,APPROVED,EUR,"0,61",EUR,810.70,,15050498,6942637757,,362b35524af4465a94d1c3a20acf815f,a759163a6e324c30a067be90b37241e7,,22/01/2023 20:33
02/02/2023 8:47,2,EUR,1,"38,2",PAY,RECEIVED,APPROVED,EUR,"1,8",EUR,808.16,,15050492,6942635141,,d32d262f980e444ebbb2a2a0ad11b83d,a759163a6e324c30a067be90b37241e7,0.046,22/01/2023 20:29
02/02/2023 7:53,2,EUR,10,"0,46",PAY,RECEIVED,APPROVED,EUR,"0,54",EUR,769.96,,2066624,1379436949,Payout description,9e0907673941453e95cbeafced765774,a759163a6e324c30a067be90b37241e7,0.052,22/01/2023 20:06
02/02/2023 7:30,2,EUR,29,"9,17",PAY,RECEIVED,APPROVED,EUR,"0,83",EUR,769.50,,2066612,1379426637,Payout description,f8cd78756de5497a8c96de4ceb09fbbf,a759163a6e324c30a067be90b37241e7,0.052,22/01/2023 20:06
02/02/2023 6:36,2,TRY,14,"-150,38",PAYOUT,SENT,APPROVED,EUR,"1,99",EUR,760.33,,15050202,6942471215,,2d3ab23a92334f3186ad2237e55a9fb5,a759163a6e324c30a067be90b37241e7,,22/01/2023 19:59
02/02/2023 5:29,2,TRY,30,"60,76",PAY,RECEIVED,APPROVED,EUR,"2,56",EUR,910.71,,15050158,6942444509,,48d5292a7aa141ef83e0b0ff526e70cb,a759163a6e324c30a067be90b37241e7,,22/01/2023 19:56
02/02/2023 5:28,2,TRY,"44,37","0,8",PAY,RECEIVED,APPROVED,EUR,"0,55",EUR,849.95,,15050141,6942434177,,b61ec4d94d644bafb86627866fe03867,a759163a6e324c30a067be90b37241e7,,22/01/2023 19:53
02/02/2023 5:12,2,EUR,600,"42,42",PAY,RECEIVED,APPROVED,EUR,"1,95",EUR,849.15,,15050083,6942392237,,1fb0ebd67f4141d08d7c20cb5493130e,a759163a6e324c30a067be90b37241e7,0.046,22/01/2023 19:47
02/02/2023 4:36,2,TRY,"1,2","-31,47",PAYOUT,SENT,APPROVED,EUR,"0,81",EUR,806.73,,15049829,6942207559,,a3e18a2c8f714049861ace2c80c25b98,a759163a6e324c30a067be90b37241e7,,22/01/2023 19:23
02/02/2023 4:34,2,EUR,101,"0,66",PAY,RECEIVED,APPROVED,EUR,"0,54",EUR,838.20,,2066427,1379346665,Payout description,298c6caeb6c24cc5b375268a02306a2e,a759163a6e324c30a067be90b37241e7,0.052,22/01/2023 19:21
02/02/2023 4:30,2,EUR,,"97,21",PAY,RECEIVED,APPROVED,EUR,"3,79",EUR,837.54,,15049767,6942166727,,81aa3a41d7fe41a3b082c0c62afe49e2,a759163a6e324c30a067be90b37241e7,0.046,22/01/2023 19:17
02/02/2023 1:51,2,EUR,20,"-20,7",PAYOUT,SENT,APPROVED,EUR,"0,7",EUR,740.33,,2066377,1379321283,Payout description,3411df4050304bcfbfb639726f51cff0,a759163a6e324c30a067be90b37241e7,0.052,22/01/2023 19:06
02/02/2023 1:06,2,TRY,750,"-39,24",PAYOUT,SENT,APPROVED,EUR,"0,89",EUR,761.03,,15049582,6942065037,,6cf4dc4c6fbe4684b060ca666869c225,a759163a6e324c30a067be90b37241e7,0.046,22/01/2023 19:01
02/02/2023 0:42,2,PLN,15,"2,39",PAY,RECEIVED,APPROVED,EUR,"0,6",EUR,800.27,,2066334,1379312411,Payout description,6ae9a9b3f9644a8f83265d960d98ee7f,a759163a6e324c30a067be90b37241e7,0.052,22/01/2023 18:51
01/02/2023 22:36,1,TRY,195,"-10,65",PAYOUT,SENT,APPROVED,EUR,"0,61",EUR,797.88,,15049365,6941936571,,c50074b793a841b2bd831ef51d44068d,a759163a6e324c30a067be90b37241e7,,22/01/2023 18:40
01/02/2023 22:31,1,EUR,10,"9,17",PAY,RECEIVED,APPROVED,EUR,"0,83",EUR,808.53,,15049058,6941745565,,97bd827f97f945ccbf81811c034469ca,a759163a6e324c30a067be90b37241e7,0.046,22/01/2023 18:09
01/02/2023 21:59,1,EUR,"11,5","10,62",PAY,RECEIVED,APPROVED,EUR,"0,88",EUR,799.36,,15049002,6941714693,,afc59fb2c0704f049a2635f3406efe00,a759163a6e324c30a067be90b37241e7,0.046,22/01/2023 18:05
01/02/2023 21:27,1,EUR,50,"47,87",PAY,RECEIVED,APPROVED,EUR,"2,13",EUR,788.74,,15049016,6941721803,,f125ec5da8ba4f388e445e1d95e0b2dd,a759163a6e324c30a067be90b37241e7,0.046,22/01/2023 18:05
01/02/2023 21:11,1,EUR,10,"9,17",PAY,RECEIVED,APPROVED,EUR,"0,83",EUR,740.87,,15048870,6941630527,,d1b3771f1cae42608751ecf673316ab5,a759163a6e324c30a067be90b37241e7,,22/01/2023 17:50
01/02/2023 20:57,1,EUR,10,"9,17",PAY,RECEIVED,APPROVED,EUR,"0,83",EUR,731.70,,15048814,6941593483,,dd851886ab444b54b110fc81c39521f0,a759163a6e324c30a067be90b37241e7,0.046,22/01/2023 17:45
01/02/2023 20:55,1,EUR,340,"328,45",PAY,RECEIVED,APPROVED,EUR,"11,55",EUR,722.53,,15048781,6941571033,,8bc4c4ba37544fe79c9f21a5011f0db6,a759163a6e324c30a067be90b37241e7,0.039,22/01/2023 17:41
01/02/2023 20:51,1,EUR,"347,2","-351,18",PAYOUT,SENT,APPROVED,EUR,"3,98",EUR,394.08,,15048739,6941539251,,dba90e51bbba4546a1f151e34ec8d934,a759163a6e324c30a067be90b37241e7,0.046,22/01/2023 17:36
01/02/2023 20:47,1,EUR,15,"14,01",PAY,RECEIVED,APPROVED,EUR,"0,99",EUR,745.26,,15048582,6941425707,,aa34872f08e24d79aabb8d724a6e15ce,a759163a6e324c30a067be90b37241e7,,22/01/2023 17:21
01/02/2023 20:11,1,EUR,15,"14,01",PAY,RECEIVED,APPROVED,EUR,"0,99",EUR,731.25,,2065898,1379154841,Payout description,ddd974d8f6c24a1c95bce0169cf4810c,a759163a6e324c30a067be90b37241e7,,22/01/2023 17:21
01/02/2023 20:01,1,TRY,101,"3,94",PAY,RECEIVED,APPROVED,EUR,"0,65",EUR,717.24,,15048542,6941402861,,184fbdffa2e845e48842441e2f8f6f98,a759163a6e324c30a067be90b37241e7,,22/01/2023 17:19
01/02/2023 19:52,1,EUR,10,"9,17",PAY,RECEIVED,APPROVED,EUR,"0,83",EUR,713.30,,2065851,1379137837,Payout description,d8dc63ff56f54242b1e043c3f194db44,a759163a6e324c30a067be90b37241e7,0.052,22/01/2023 17:06
01/02/2023 19:50,1,TRY,56,"1,95",PAY,RECEIVED,APPROVED,EUR,"0,59",EUR,704.13,,2065613,1379044161,Payout description,300a5a48924a4081850a57b9071f2496,a759163a6e324c30a067be90b37241e7,0.052,22/01/2023 16:06
01/02/2023 19:39,1,EUR,15,"14,01",PAY,RECEIVED,APPROVED,EUR,"0,99",EUR,702.18,,15047782,6940767501,,75009e46f2084845b4ad69d8e4b78cf4,a759163a6e324c30a067be90b37241e7,,22/01/2023 16:02
01/02/2023 19:36,1,TRY,1459,"-762,15",PAYOUT,SENT,APPROVED,EUR,"8,05",EUR,688.17,,15047572,6940648683,,23cf8510531f4c00a6ca45e4c96b7873,a759163a6e324c30a067be90b37241e7,0.046,22/01/2023 15:50
01/02/2023 19:14,1,TRY,250,"10,55",PAY,RECEIVED,APPROVED,EUR,"0,88",EUR,1450.32,,2065525,1379011679,Payout description,7a27a6a9d0d048a683abf6e18cc190a4,a759163a6e324c30a067be90b37241e7,0.052,22/01/2023 15:36
01/02/2023 19:01,1,EUR,10,"9,17",PAY,RECEIVED,APPROVED,EUR,"0,83",EUR,1439.77,,15047306,6940444815,,857e452c7e89434fbf3fb91bc8570133,a759163a6e324c30a067be90b37241e7,0.046,22/01/2023 15:27
01/02/2023 18:36,1,TRY,313,"-16,84",PAYOUT,SENT,APPROVED,EUR,"0,67",EUR,1430.60,,15046636,6939877159,,16b20065e22943efa513b1abf54ecf91,a759163a6e324c30a067be90b37241e7,,22/01/2023 14:21
01/02/2023 18:29,1,PLN,35,"6,25",PAY,RECEIVED,APPROVED,EUR,"0,73",EUR,1447.44,,15046638,6939877511,,269b851810fb41b6ba55ce138e0f48f2,a759163a6e324c30a067be90b37241e7,0.209,22/01/2023 14:20
01/02/2023 18:25,1,TRY,102,4,PAY,RECEIVED,APPROVED,EUR,"0,66",EUR,1441.19,,15046584,6939824563,,ef8771cea0024cae8106f8b89e431221,a759163a6e324c30a067be90b37241e7,0.046,22/01/2023 14:14
01/02/2023 18:06,1,EUR,101,"97,21",PAY,RECEIVED,APPROVED,EUR,"3,79",EUR,1437.19,,15046419,6939669301,,974495392eba4510bf44613a29622708,a759163a6e324c30a067be90b37241e7,,22/01/2023 13:59
01/02/2023 18:01,1,EUR,"540,16","522,1",PAY,RECEIVED,APPROVED,EUR,"18,06",EUR,1339.98,,15046155,6939415633,,f640478f2d104b0b8dcbcb2f5970736a,a759163a6e324c30a067be90b37241e7,0.084,22/01/2023 13:31
01/02/2023 17:55,1,TRY,50,"1,7",PAY,RECEIVED,APPROVED,EUR,"0,58",EUR,817.88,,15045936,6939207431,,eed6f81ecd6d42dda020f2bc99aa7996,a759163a6e324c30a067be90b37241e7,0.084,22/01/2023 13:10
01/02/2023 17:30,1,EUR,101,"97,21",PAY,RECEIVED,APPROVED,EUR,"3,79",EUR,816.18,,15045737,6939047543,,41eee375cefe4e9fb1e1ba56867c52cd,a759163a6e324c30a067be90b37241e7,,22/01/2023 12:56
01/02/2023 17:13,1,EUR,10,"9,17",PAY,RECEIVED,APPROVED,EUR,"0,83",EUR,718.97,,2064986,1378766757,Payout description,d47ea667e884461a8fea20cb6959b35d,a759163a6e324c30a067be90b37241e7,0.236,22/01/2023 12:36
01/02/2023 17:07,1,EUR,"51,01","48,85",PAY,RECEIVED,APPROVED,EUR,"2,16",EUR,709.80,,15045091,6938517555,,87b63bc238d648a984689826852b80ae,a759163a6e324c30a067be90b37241e7,,22/01/2023 12:00
01/02/2023 17:06,1,EUR,20,"-20,7",PAYOUT,SENT,APPROVED,EUR,"0,7",EUR,660.95,,15045008,6938425405,,13cbd5e3f55c4a019d0fa5f4ffb65b2b,a759163a6e324c30a067be90b37241e7,0.046,22/01/2023 11:49
01/02/2023 16:56,1,EUR,206,"198,8",PAY,RECEIVED,APPROVED,EUR,"7,2",EUR,681.65,,2064831,1378686391,Payout description,9eb2d9c406114e678ab26c8260dccef8,a759163a6e324c30a067be90b37241e7,0.052,22/01/2023 11:36
01/02/2023 16:49,1,EUR,101,"97,21",PAY,RECEIVED,APPROVED,EUR,"3,79",EUR,482.85,,2064825,1378678427,Payout description,657b0c1704214583bc4c5b25a1b379c5,a759163a6e324c30a067be90b37241e7,0.052,22/01/2023 11:36
01/02/2023 16:36,1,EUR,130,"-131,8",PAYOUT,SENT,APPROVED,EUR,"1,8",EUR,385.64,,15044633,6938089879,,fad3b28c38634085a0351f5076a83fa0,a759163a6e324c30a067be90b37241e7,,22/01/2023 11:13
01/02/2023 16:25,1,EUR,50,"47,87",PAY,RECEIVED,APPROVED,EUR,"2,13",EUR,517.44,,15044613,6938070375,,4529d1527ef645dab632fa4d85a41ac3,a759163a6e324c30a067be90b37241e7,,22/01/2023 11:12
01/02/2023 16:23,1,EUR,"100,51","96,74",PAY,RECEIVED,APPROVED,EUR,"3,77",EUR,469.57,,15044590,6938053409,,f2e62c09ddd24fe4ae0b287b067e17f8,a759163a6e324c30a067be90b37241e7,,22/01/2023 11:10
01/02/2023 16:06,1,EUR,"188,49","-190,88",PAYOUT,SENT,APPROVED,EUR,"2,39",EUR,372.83,,15044492,6937977875,,803604609bb34d41b84de055fe41f32c,a759163a6e324c30a067be90b37241e7,0.046,22/01/2023 11:00
01/02/2023 15:51,1,TRY,36,"-2,38",PAYOUT,SENT,APPROVED,EUR,"0,52",EUR,563.71,,15044308,6937838401,,d24499dbbc0541b88366aad1287fbf5b,a759163a6e324c30a067be90b37241e7,0.046,22/01/2023 10:43
01/02/2023 15:22,1,TRY,12611,"558,81",PAY,RECEIVED,APPROVED,EUR,"19,29",EUR,566.09,,15044066,6937648401,,06fd493e4b324a8e9e460d3c09f60e8d,a759163a6e324c30a067be90b37241e7,0.046,22/01/2023 10:17
01/02/2023 15:21,1,TRY,126,"-658,48",PAYOUT,SENT,APPROVED,EUR,"7,02",EUR,7.28,,15043938,6937566981,,1232b0905a324cac9a47675874a1658e,a759163a6e324c30a067be90b37241e7,0.046,22/01/2023 10:06
01/02/2023 15:11,1,TRY,5,"221,1",PAY,RECEIVED,APPROVED,EUR,"7,95",EUR,665.76,,15043903,6937546321,,c4a7f4d5e1c647edb4e50010bb3fa512,a759163a6e324c30a067be90b37241e7,0.046,22/01/2023 10:03
01/02/2023 14:58,1,EUR,10,"9,17",PAY,RECEIVED,APPROVED,EUR,"0,83",EUR,444.66,,15043790,6937487993,,281d967ab9f8454d887bd7ee7d4e4725,a759163a6e324c30a067be90b37241e7,0.046,22/01/2023 9:54
01/02/2023 14:51,1,EUR,100,"96,25",PAY,RECEIVED,APPROVED,EUR,"3,75",EUR,435.49,,15043696,6937430069,,c95a84803e604eaaa9647d6dd19281c8,a759163a6e324c30a067be90b37241e7,,22/01/2023 9:45
01/02/2023 14:38,1,EUR,50,"47,87",PAY,RECEIVED,APPROVED,EUR,"2,13",EUR,339.24,,15043533,6937340385,,ee809b7bd40e4f54b27dbfb792e28dbc,a759163a6e324c30a067be90b37241e7,0.046,22/01/2023 9:31
01/02/2023 14:27,1,EUR,50,"47,87",PAY,RECEIVED,APPROVED,EUR,"2,13",EUR,291.37,,15042800,6936833195,,0adc1d3b91b64fc7ac808817831db62c,a759163a6e324c30a067be90b37241e7,,22/01/2023 7:55
01/02/2023 13:56,1,TRY,800,"34,92",PAY,RECEIVED,APPROVED,EUR,"1,7",EUR,243.50,,15042728,6936748221,,d092f89df6684e86bd3e637d04b7c3c1,a759163a6e324c30a067be90b37241e7,0.046,22/01/2023 7:35
01/02/2023 13:36,1,EUR,"70,22","-71,43",PAYOUT,SENT,APPROVED,EUR,"1,21",EUR,208.58,,2064099,1378343793,Payout description,651faede74b240508fc0bad566597a0f,a759163a6e324c30a067be90b37241e7,0.236,22/01/2023 5:51
01/02/2023 13:15,1,EUR,14,"13,04",PAY,RECEIVED,APPROVED,EUR,"0,96",EUR,280.01,,15041317,6935799327,,75edb810e4b0477bba98b351fced96c9,a759163a6e324c30a067be90b37241e7,0.209,22/01/2023 0:39
01/02/2023 12:55,1,EUR,50,"47,87",PAY,RECEIVED,APPROVED,EUR,"2,13",EUR,266.97,,15041278,6935782665,,5914a4b1fd2e40cabe082dcc77ec24cc,a759163a6e324c30a067be90b37241e7,0.046,22/01/2023 0:32
01/02/2023 12:38,1,PLN,10,"1,42",PAY,RECEIVED,APPROVED,EUR,"0,57",EUR,219.10,,15041193,6935739455,,ee48ecdbfbfc4eb5acd36cb79a4670a0,a759163a6e324c30a067be90b37241e7,0.046,22/01/2023 0:16
01/02/2023 12:31,1,TRY,70,"2,59",PAY,RECEIVED,APPROVED,EUR,"0,61",EUR,217.68,,2063772,1378139569,Payout description,515d1a3785d24bed81675c9d8e363240,a759163a6e324c30a067be90b37241e7,0.052,21/01/2023 23:51
01/02/2023 12:25,1,TRY,500,"21,67",PAY,RECEIVED,APPROVED,EUR,"1,25",EUR,215.09,,2063724,1378093173,Payout description,99bfe314312e42a9b301e95f6b9bdcf2,a759163a6e324c30a067be90b37241e7,0.052,21/01/2023 23:21
01/02/2023 12:19,1,TRY,250,"10,58",PAY,RECEIVED,APPROVED,EUR,"0,88",EUR,193.42,,2063696,1378081311,Payout description,52335e9fa0bf4ceabe8de6c4535c4a17,a759163a6e324c30a067be90b37241e7,0.052,21/01/2023 23:06
01/02/2023 12:05,1,EUR,15,"14,01",PAY,RECEIVED,APPROVED,EUR,"0,99",EUR,182.84,,15040761,6935514169,,814da9c56439473086c39a89d7d9b8c8,a759163a6e324c30a067be90b37241e7,0.046,21/01/2023 23:04
01/02/2023 11:23,1,PLN,10,"1,42",PAY,RECEIVED,APPROVED,EUR,"0,57",EUR,168.83,,15040674,6935473549,,5746fdf7b829442180ac8c115cea6867,a759163a6e324c30a067be90b37241e7,,21/01/2023 22:55
01/02/2023 10:34,1,EUR,5,"4,33",PAY,RECEIVED,APPROVED,EUR,"0,67",EUR,167.41,,2063649,1378047297,Payout description,76ff8ebe2b2244cc84431552691f58b8,a759163a6e324c30a067be90b37241e7,,21/01/2023 22:51
01/02/2023 10:33,1,EUR,15,"14,01",PAY,RECEIVED,APPROVED,EUR,"0,99",EUR,163.08,,15040605,6935432171,,398ebec50ef644f5a5977a21e6b68ab1,a759163a6e324c30a067be90b37241e7,,21/01/2023 22:43
01/02/2023 10:23,1,EUR,76,"73,03",PAY,RECEIVED,APPROVED,EUR,"2,97",EUR,149.07,,15040459,6935359553,,44446fa64f7d4692a92bf6cda43de495,a759163a6e324c30a067be90b37241e7,0.046,21/01/2023 22:26
01/02/2023 9:41,1,EUR,10,"9,17",PAY,RECEIVED,APPROVED,EUR,"0,83",EUR,76.04,,15040389,6935316361,,fbdd36b479ed4ed0a05915011a2de7c9,a759163a6e324c30a067be90b37241e7,0.046,21/01/2023 22:16
01/02/2023 8:51,1,TRY,400,"-21,42",PAYOUT,SENT,APPROVED,EUR,"0,71",EUR,66.87,,2063515,1377963727,Payout description,e16504b2c4fe4945ad45f77ab467faf2,a759163a6e324c30a067be90b37241e7,0.052,21/01/2023 22:06
01/02/2023 7:58,1,PLN,126,"23,83",PAY,RECEIVED,APPROVED,EUR,"1,32",EUR,88.29,,15040231,6935226829,,5acdfd0039cd45fe9f7741ed121a6bf7,a759163a6e324c30a067be90b37241e7,,21/01/2023 21:58
01/02/2023 7:40,1,TRY,464,"20,11",PAY,RECEIVED,APPROVED,EUR,"1,2",EUR,64.46,,15040208,6935217947,,7141e457b1c14789aae9402bf94efefe,a759163a6e324c30a067be90b37241e7,,21/01/2023 21:56
01/02/2023 3:48,1,TRY,1,"43,93",PAY,RECEIVED,APPROVED,EUR,2,EUR,44.35,,15039978,6935106867,,8874e502cddb4cc184758c718365004a,a759163a6e324c30a067be90b37241e7,0.046,21/01/2023 21:32
01/02/2023 0:51,1,PLN,50,"-11,89",PAYOUT,SENT,APPROVED,EUR,"0,62",EUR,0.42,,15039902,6935071689,,4cd8630c77b94a39830aa20ed8d53884,a759163a6e324c30a067be90b37241e7,0.046,21/01/2023 21:25
01/02/2023 0:21,1,PLN,13,"-3,46",PAYOUT,SENT,APPROVED,EUR,"0,53",EUR,12.31,,15039745,6935008949,,20df819fe31d48acb1c1bc87d655e591,a759163a6e324c30a067be90b37241e7,,21/01/2023 21:11
31/01/2023 23:02,31,PLN,"6,1","0,67",PAY,RECEIVED,APPROVED,EUR,"0,54",EUR,15.77,,15039580,6934940667,,be7fb6aa5aa24cbb868b2f2de06aae5a,a759163a6e324c30a067be90b37241e7,,21/01/2023 20:58
31/01/2023 22:21,31,EUR,50,-51,PAYOUT,SENT,APPROVED,EUR,1,EUR,15.10,,15039425,6934857517,,4e5552025eed4e489d0308aba7b8268e,a759163a6e324c30a067be90b37241e7,0.209,21/01/2023 20:52
31/01/2023 22:06,31,EUR,199,"-201,49",PAYOUT,SENT,APPROVED,EUR,"2,49",EUR,66.10,,2063271,1377875593,Payout description,608421cce5144131b5f6a0b0961e5d63,a759163a6e324c30a067be90b37241e7,0.052,21/01/2023 20:51
31/01/2023 21:51,31,TRY,6,"-314,91",PAYOUT,SENT,APPROVED,EUR,"3,62",EUR,267.59,,2063267,1377867811,Payout description,df9f6b546ad945bf82c132b90fac39ec,a759163a6e324c30a067be90b37241e7,,21/01/2023 20:51
31/01/2023 21:24,31,TRY,400,"17,26",PAY,RECEIVED,APPROVED,EUR,"1,1",EUR,582.50,,15039411,6934851261,,7691fa636b4c413e8239ec1c75697fd5,a759163a6e324c30a067be90b37241e7,0.209,21/01/2023 20:41
31/01/2023 21:02,31,PLN,300,"57,43",PAY,RECEIVED,APPROVED,EUR,"2,45",EUR,565.24,,2063196,1377835443,Payout description,353fc47e4aa944aaa95e40a1c760c975,a759163a6e324c30a067be90b37241e7,0.052,21/01/2023 20:21
31/01/2023 20:58,31,EUR,100,"96,25",PAY,RECEIVED,APPROVED,EUR,"3,75",EUR,507.81,,15039204,6934729663,,8f795912ad764ada8dd78b1c381a154b,a759163a6e324c30a067be90b37241e7,0.046,21/01/2023 20:18
31/01/2023 20:53,31,PLN,100,"18,8",PAY,RECEIVED,APPROVED,EUR,"1,15",EUR,411.56,,15038601,6934380151,,420e554e24e44513bbe7772559958379,a759163a6e324c30a067be90b37241e7,0.046,21/01/2023 19:24
31/01/2023 20:43,31,PLN,50,"9,14",PAY,RECEIVED,APPROVED,EUR,"0,83",EUR,392.76,,15038240,6934154313,,45420607d78a4182886fe536e50148a1,a759163a6e324c30a067be90b37241e7,,21/01/2023 18:51
31/01/2023 20:32,31,PLN,30,"5,28",PAY,RECEIVED,APPROVED,EUR,"0,7",EUR,383.62,,2062891,1377695513,Payout description,64a22af2f7ae42e88c84e368a44790d4,a759163a6e324c30a067be90b37241e7,0.052,21/01/2023 18:51
31/01/2023 20:06,31,TRY,1095,"-57,88",PAYOUT,SENT,APPROVED,EUR,"1,07",EUR,378.34,,2062888,1377682723,Payout description,909e97e1df154f69b4400ca5621e8058,a759163a6e324c30a067be90b37241e7,0.012,21/01/2023 18:51
31/01/2023 19:47,31,TRY,800,"35,01",PAY,RECEIVED,APPROVED,EUR,"1,7",EUR,436.22,,2062849,1377679503,Payout description,bf156cdf72294c9589ed7f6f21a924ac,a759163a6e324c30a067be90b37241e7,0.052,21/01/2023 18:36
31/01/2023 19:45,31,TRY,1,"43,89",PAY,RECEIVED,APPROVED,EUR,2,EUR,401.21,,15038057,6934054517,,1b134a0dcbc948d7886013b4c97725e9,a759163a6e324c30a067be90b37241e7,0.046,21/01/2023 18:34
31/01/2023 19:41,31,EUR,10,"9,17",PAY,RECEIVED,APPROVED,EUR,"0,83",EUR,357.32,,15038034,6934036563,,e67a6ffe3c2b4f769c98a8ae2f78889f,a759163a6e324c30a067be90b37241e7,,21/01/2023 18:34
31/01/2023 19:37,31,TRY,280,"11,92",PAY,RECEIVED,APPROVED,EUR,"0,92",EUR,348.15,,15038050,6934046429,,9bdb42b6a91746b5ba2cbaed0a4b1ede,a759163a6e324c30a067be90b37241e7,0.046,21/01/2023 18:33
31/01/2023 19:36,31,TRY,1314,"-69,3",PAYOUT,SENT,APPROVED,EUR,"1,19",EUR,336.23,,15037853,6933927191,,520bd14acadb41a297b79df63be95e0e,a759163a6e324c30a067be90b37241e7,,21/01/2023 18:15
31/01/2023 19:35,31,EUR,"27,06","25,68",PAY,RECEIVED,APPROVED,EUR,"1,38",EUR,405.53,,15037732,6933856169,,3c094fc8ed934b3499039e8ac81449d2,a759163a6e324c30a067be90b37241e7,,21/01/2023 18:06
31/01/2023 19:28,31,EUR,"41,95","40,08",PAY,RECEIVED,APPROVED,EUR,"1,87",EUR,379.85,,15037536,6933693555,,6bc9ab65eebd4b2c9484414f456927aa,a759163a6e324c30a067be90b37241e7,0.046,21/01/2023 17:40
31/01/2023 19:14,31,EUR,24,"22,72",PAY,RECEIVED,APPROVED,EUR,"1,28",EUR,339.77,,15037505,6933673123,,212d6f3c8aeb41489158d794919c20fe,a759163a6e324c30a067be90b37241e7,0.046,21/01/2023 17:37
31/01/2023 19:09,31,EUR,10,"9,17",PAY,RECEIVED,APPROVED,EUR,"0,83",EUR,317.05,,2062571,1377592145,Payout description,43d2b2e430664856ad4aeec3b4553e13,a759163a6e324c30a067be90b37241e7,0.052,21/01/2023 17:36
31/01/2023 19:06,31,EUR,"41,95","-42,87",PAYOUT,SENT,APPROVED,EUR,"0,92",EUR,307.88,,15037274,6933501711,,376fed665b6c41c08669575f28f30c9b,a759163a6e324c30a067be90b37241e7,0.046,21/01/2023 17:17
31/01/2023 19:06,31,EUR,199,"192,03",PAY,RECEIVED,APPROVED,EUR,"6,97",EUR,350.75,,15037242,6933477313,,eedde5cdc1574df4af40db1b456bdc4f,a759163a6e324c30a067be90b37241e7,0.046,21/01/2023 17:14
31/01/2023 18:30,31,PLN,100,"18,81",PAY,RECEIVED,APPROVED,EUR,"1,15",EUR,158.72,,2062425,1377517951,Payout description,da43f38de61c415c99afcfa4a212630e,a759163a6e324c30a067be90b37241e7,0.052,21/01/2023 16:51
31/01/2023 18:23,31,PLN,200,"38,12",PAY,RECEIVED,APPROVED,EUR,"1,8",EUR,139.91,,15036830,6933164473,,0b0464e571134c8d8cda414075041330,a759163a6e324c30a067be90b37241e7,0.046,21/01/2023 16:37
31/01/2023 18:09,31,PLN,20,"3,36",PAY,RECEIVED,APPROVED,EUR,"0,63",EUR,101.79,,2062392,1377508575,Payout description,860ae567a2ee48a4bdf4f8f23309e20d,a759163a6e324c30a067be90b37241e7,0.052,21/01/2023 16:36
31/01/2023 17:47,31,PLN,"6,8","0,8",PAY,RECEIVED,APPROVED,EUR,"0,55",EUR,98.43,,2062390,1377505583,Payout description,90f3456acfc64ed5ac06e74886236604,a759163a6e324c30a067be90b37241e7,,21/01/2023 16:36
31/01/2023 17:06,31,PLN,500,"-114,22",PAYOUT,SENT,APPROVED,EUR,"1,63",EUR,97.63,,15036783,6933127195,,6b2425d591af43e88089e350899661b9,a759163a6e324c30a067be90b37241e7,,21/01/2023 16:34
31/01/2023 17:05,31,EUR,"119,08","114,7",PAY,RECEIVED,APPROVED,EUR,"4,38",EUR,211.85,,2062295,1377461795,Payout description,72b9aae6e94d4dc2963ff119c1f76ccf,a759163a6e324c30a067be90b37241e7,0.052,21/01/2023 16:06
31/01/2023 17:02,31,EUR,10,"9,17",PAY,RECEIVED,APPROVED,EUR,"0,83",EUR,97.15,,15036398,6932866615,,7fd2ce8d23bc4bfc8a66ec4fd2401dca,a759163a6e324c30a067be90b37241e7,0.046,21/01/2023 16:00
31/01/2023 16:36,31,PLN,300,"57,4",PAY,RECEIVED,APPROVED,EUR,"2,45",EUR,87.98,,15036299,6932822577,,a50ea4517ceb430aa4972d30d646cac5,a759163a6e324c30a067be90b37241e7,0.046,21/01/2023 15:55
31/01/2023 16:21,31,EUR,150,-152,PAYOUT,SENT,APPROVED,EUR,2,EUR,30.58,,15036249,6932788249,,5b599551c5d8416387090a3d4239c5cf,a759163a6e324c30a067be90b37241e7,,21/01/2023 15:50
31/01/2023 16:14,31,EUR,"50,11","47,98",PAY,RECEIVED,APPROVED,EUR,"2,13",EUR,182.58,,2062217,1377414511,Payout description,af0e1f411a6f485c907728f1ec4119c1,a759163a6e324c30a067be90b37241e7,0.052,21/01/2023 15:36
31/01/2023 15:59,31,PLN,200,"38,09",PAY,RECEIVED,APPROVED,EUR,"1,8",EUR,134.60,,15035967,6932629019,,2076db8c0f3c49a59cbeaa36d0ecc235,a759163a6e324c30a067be90b37241e7,0.046,21/01/2023 15:30
31/01/2023 15:51,31,EUR,"42,44","-43,37",PAYOUT,SENT,APPROVED,EUR,"0,93",EUR,96.51,,2062173,1377397753,Payout description,ae6391696aed463b814c70a4aa374001,a759163a6e324c30a067be90b37241e7,0.052,21/01/2023 15:21
31/01/2023 15:51,31,PLN,500,"-114,25",PAYOUT,SENT,APPROVED,EUR,"1,63",EUR,139.88,,2062164,1377388499,Payout description,1ddb6d9c09984519acda6182ae392472,a759163a6e324c30a067be90b37241e7,0.052,21/01/2023 15:21
31/01/2023 15:36,31,EUR,199,"-201,49",PAYOUT,SENT,APPROVED,EUR,"2,49",EUR,254.13,,15035819,6932529807,,49fa68ca1c624b588703ebe1b8377d7a,a759163a6e324c30a067be90b37241e7,0.046,21/01/2023 15:18
31/01/2023 15:26,31,TRY,5,"222,35",PAY,RECEIVED,APPROVED,EUR,"7,99",EUR,455.62,,15035789,6932515227,,aa22def5d2a248a99021d4d93e472318,a759163a6e324c30a067be90b37241e7,,21/01/2023 15:16
31/01/2023 15:12,31,TRY,2,"88,62",PAY,RECEIVED,APPROVED,EUR,"3,5",EUR,233.27,,15035719,6932463091,,e8947f27484545e982e5c156da9814a0,a759163a6e324c30a067be90b37241e7,,21/01/2023 15:10
31/01/2023 15:04,31,EUR,80,"76,9",PAY,RECEIVED,APPROVED,EUR,"3,1",EUR,144.65,,15035723,6932465661,,39be0fcc033d41aa84f9edcf0decd4c4,a759163a6e324c30a067be90b37241e7,,21/01/2023 15:10
31/01/2023 15:04,31,PLN,100,"18,8",PAY,RECEIVED,APPROVED,EUR,"1,15",EUR,67.75,,15035490,6932290205,,30d3a080fb434df1b20cf77eb084a1fd,a759163a6e324c30a067be90b37241e7,,21/01/2023 14:51
31/01/2023 14:51,31,TRY,10,"-525,03",PAYOUT,SENT,APPROVED,EUR,"5,7",EUR,48.95,,15035405,6932211973,,8d6c67ffa62544e59b6307ad5f898466,a759163a6e324c30a067be90b37241e7,0.046,21/01/2023 14:43
31/01/2023 14:37,31,PLN,51,"9,33",PAY,RECEIVED,APPROVED,EUR,"0,84",EUR,573.98,,2061981,1377318123,Payout description,940635f166764ecb9eab4d6289f5c520,a759163a6e324c30a067be90b37241e7,0.052,21/01/2023 14:21
31/01/2023 14:12,31,TRY,16,"70,74",PAY,RECEIVED,APPROVED,EUR,"2,9",EUR,564.65,,15035117,6931962883,,85512847b6fc42cfb08e3ab3c16218ce,a759163a6e324c30a067be90b37241e7,,21/01/2023 14:20
31/01/2023 14:11,31,EUR,"1,1","0,56",PAY,RECEIVED,APPROVED,EUR,"0,54",EUR,493.91,,15034978,6931859115,,a3bb5c12884b414186a0972d1ab059d9,a759163a6e324c30a067be90b37241e7,0.046,21/01/2023 14:07
31/01/2023 14:10,31,PLN,35,"6,25",PAY,RECEIVED,APPROVED,EUR,"0,73",EUR,493.35,,2061954,1377300055,Payout description,414af4a0dce940fbb0b1cdeb72fa598c,a759163a6e324c30a067be90b37241e7,0.052,21/01/2023 14:06
31/01/2023 14:06,31,JPY,30,"-228,22",PAYOUT,SENT,APPROVED,EUR,"2,76",EUR,487.10,,15034954,6931846223,,6b3581e4c8644359a54be9e89514ceaa,a759163a6e324c30a067be90b37241e7,,21/01/2023 14:06
31/01/2023 13:54,31,EUR,"2,77","2,17",PAY,RECEIVED,APPROVED,EUR,"0,6",EUR,715.32,,15034881,6931793009,,16b285ea44d84730898b94c28df2a8e6,a759163a6e324c30a067be90b37241e7,0.011,21/01/2023 14:00
31/01/2023 13:47,31,EUR,"1,57","1,01",PAY,RECEIVED,APPROVED,EUR,"0,56",EUR,713.15,,15034731,6931692269,,760fa50f506e4bb2b381de401b5ba631,a759163a6e324c30a067be90b37241e7,0.011,21/01/2023 13:53
31/01/2023 13:39,31,EUR,10,"9,17",PAY,RECEIVED,APPROVED,EUR,"0,83",EUR,712.14,,15034760,6931711687,,43b14e9fbcba4f3db8d66349d6ffe0aa,a759163a6e324c30a067be90b37241e7,0.046,21/01/2023 13:50
31/01/2023 13:36,31,INR,200,"-2,92",PAYOUT,SENT,APPROVED,EUR,"0,53",EUR,702.97,,15034684,6931656863,,33346ef5d28d43ce987dba4384437187,a759163a6e324c30a067be90b37241e7,0.011,21/01/2023 13:45
31/01/2023 13:35,31,EUR,502,"485,18",PAY,RECEIVED,APPROVED,EUR,"16,82",EUR,705.89,,15034569,6931572761,,2ad6b9d2189f45d1b71d03548b37d0b6,a759163a6e324c30a067be90b37241e7,0.011,21/01/2023 13:35
31/01/2023 13:14,31,PLN,51,"9,34",PAY,RECEIVED,APPROVED,EUR,"0,84",EUR,220.71,,15034493,6931489819,,10a5344c6856423480218850e6282fcf,a759163a6e324c30a067be90b37241e7,,21/01/2023 13:27
31/01/2023 13:01,31,EUR,"19,61","18,47",PAY,RECEIVED,APPROVED,EUR,"1,14",EUR,211.37,,15034419,6931418429,,1a097d8c3caf42f99a50f0945598764e,a759163a6e324c30a067be90b37241e7,,21/01/2023 13:18
31/01/2023 12:41,31,EUR,70,"67,22",PAY,RECEIVED,APPROVED,EUR,"2,78",EUR,192.90,,15034314,6931334909,,e929f227a4da44a985c89df83225e2d7,a759163a6e324c30a067be90b37241e7,,21/01/2023 13:09
31/01/2023 12:40,31,EUR,7,"6,27",PAY,RECEIVED,APPROVED,EUR,"0,73",EUR,125.68,,2061797,1377221491,Payout description,bd51adbdef7e4edc96a9f2df9f27e87e,a759163a6e324c30a067be90b37241e7,0.236,21/01/2023 13:06
31/01/2023 12:40,31,TRY,390,"16,89",PAY,RECEIVED,APPROVED,EUR,"1,09",EUR,119.41,,15034214,6931230453,,ab91724521d84ddfaf2cf484d45a1075,a759163a6e324c30a067be90b37241e7,0.046,21/01/2023 12:58
31/01/2023 12:36,31,EUR,20,"-20,7",PAYOUT,SENT,APPROVED,EUR,"0,7",EUR,102.52,,15034138,6931182411,,479ca335843b4404824d5af6153b4c27,a759163a6e324c30a067be90b37241e7,,21/01/2023 12:55
31/01/2023 12:35,31,PLN,10,"1,42",PAY,RECEIVED,APPROVED,EUR,"0,57",EUR,123.22,,15034042,6931093367,,9470c9892fdf469aa25c72d1c35b53b7,a759163a6e324c30a067be90b37241e7,,21/01/2023 12:45
31/01/2023 12:21,31,EUR,35,"-35,85",PAYOUT,SENT,APPROVED,EUR,"0,85",EUR,121.80,,15033801,6930849147,,b03b3111d72747798da9f1d001ac1768,a759163a6e324c30a067be90b37241e7,,21/01/2023 12:23
31/01/2023 12:19,31,PLN,"16,21","2,62",PAY,RECEIVED,APPROVED,EUR,"0,61",EUR,157.65,,15033804,6930851665,,a2385ddb319443168ba3e7ec753de00e,a759163a6e324c30a067be90b37241e7,,21/01/2023 12:23
31/01/2023 12:02,31,EUR,5,"4,33",PAY,RECEIVED,APPROVED,EUR,"0,67",EUR,155.03,,2061708,1377179859,Payout description,301ead50cb65481aad126db3a61a0b81,a759163a6e324c30a067be90b37241e7,0.052,21/01/2023 12:21
31/01/2023 11:59,31,PLN,30,"5,28",PAY,RECEIVED,APPROVED,EUR,"0,7",EUR,150.70,,15033687,6930727167,,18d397f66396496a826690f607af9179,a759163a6e324c30a067be90b37241e7,,21/01/2023 12:12
31/01/2023 11:47,31,EUR,50,"47,87",PAY,RECEIVED,APPROVED,EUR,"2,13",EUR,145.42,,15033598,6930651403,,38a3ec164fda43b2a26cf90e37063bb0,a759163a6e324c30a067be90b37241e7,,21/01/2023 12:05
31/01/2023 11:35,31,PLN,12,"1,81",PAY,RECEIVED,APPROVED,EUR,"0,58",EUR,97.55,,15033443,6930517763,,a7a2d2fed3c04f34b0ac693ae39ebde1,a759163a6e324c30a067be90b37241e7,0.209,21/01/2023 11:51
31/01/2023 11:17,31,PLN,100,"18,81",PAY,RECEIVED,APPROVED,EUR,"1,15",EUR,95.74,,15033329,6930411989,,630b45d26feb40d8a0791ffadbcac607,a759163a6e324c30a067be90b37241e7,0.046,21/01/2023 11:41
31/01/2023 11:01,31,PLN,10,"1,42",PAY,RECEIVED,APPROVED,EUR,"0,57",EUR,76.93,,2061604,1377123941,Payout description,7be6919c17694d91b88eb4bde691d8a6,a759163a6e324c30a067be90b37241e7,0.052,21/01/2023 11:36
31/01/2023 10:52,31,EUR,"30,57","29,07",PAY,RECEIVED,APPROVED,EUR,"1,5",EUR,75.51,,2061599,1377117763,Payout description,f22f34ed3f7f4c218cfa527b5bf5064a,a759163a6e324c30a067be90b37241e7,,21/01/2023 11:36
31/01/2023 10:51,31,TRY,15,"-789,12",PAYOUT,SENT,APPROVED,EUR,"8,31",EUR,46.44,,15033177,6930276177,,4522ec476b5c4b6d84d9c275cad7fa88,a759163a6e324c30a067be90b37241e7,,21/01/2023 11:29
31/01/2023 10:48,31,PLN,500,"96,02",PAY,RECEIVED,APPROVED,EUR,"3,75",EUR,835.56,,15032530,6929786203,,532e1db1fd14438db8bfdd8bc13cdfa5,a759163a6e324c30a067be90b37241e7,0.046,21/01/2023 10:33
31/01/2023 10:45,31,EUR,"268,58","259,35",PAY,RECEIVED,APPROVED,EUR,"9,23",EUR,739.54,,15032508,6929771009,,67a2ab2589e746399a2d0d633867ea7a,a759163a6e324c30a067be90b37241e7,,21/01/2023 10:31
31/01/2023 10:36,31,TRY,388,"-20,92",PAYOUT,SENT,APPROVED,EUR,"0,71",EUR,480.19,,15032419,6929708531,,4a774e3852714545a62b88c63ae5b874,a759163a6e324c30a067be90b37241e7,,21/01/2023 10:23
31/01/2023 10:35,31,PLN,400,"76,7",PAY,RECEIVED,APPROVED,EUR,"3,1",EUR,501.11,,15032161,6929530085,,6f13b96d486043b18a699be8132f6c01,a759163a6e324c30a067be90b37241e7,0.046,21/01/2023 9:59
31/01/2023 10:29,31,PLN,52,"9,54",PAY,RECEIVED,APPROVED,EUR,"0,84",EUR,424.41,,15031729,6929264371,,f31c8af7e3f64d23b4d093d9c4edd837,a759163a6e324c30a067be90b37241e7,,21/01/2023 9:28
31/01/2023 10:28,31,EUR,275,"265,56",PAY,RECEIVED,APPROVED,EUR,"9,44",EUR,414.87,,15031528,6929136157,,16b1cdb7a66f4756ac37b27bfd9af6d3,a759163a6e324c30a067be90b37241e7,,21/01/2023 9:05
31/01/2023 10:19,31,EUR,10,"9,17",PAY,RECEIVED,APPROVED,EUR,"0,83",EUR,149.31,,15031460,6929095559,,4cf8adb950b34b2b8fff80c4d0d43087,a759163a6e324c30a067be90b37241e7,0.046,21/01/2023 8:59
31/01/2023 10:13,31,EUR,20,"18,85",PAY,RECEIVED,APPROVED,EUR,"1,15",EUR,140.14,,15031377,6929028175,,70ca798733e34c2f9fad137f1a31ccda,a759163a6e324c30a067be90b37241e7,0.046,21/01/2023 8:48
31/01/2023 10:06,31,EUR,19,"-19,69",PAYOUT,SENT,APPROVED,EUR,"0,69",EUR,121.29,,15031363,6929019497,,89ef820c434f4dd5a488d61f7f4ea304,a759163a6e324c30a067be90b37241e7,,21/01/2023 8:47
31/01/2023 10:02,31,PLN,103,"19,38",PAY,RECEIVED,APPROVED,EUR,"1,17",EUR,140.98,,15031220,6928922035,,a0d180325eb44af193986dbd6e15638f,a759163a6e324c30a067be90b37241e7,,21/01/2023 8:30
31/01/2023 9:51,31,TRY,10,"-526,28",PAYOUT,SENT,APPROVED,EUR,"5,71",EUR,121.60,,15031140,6928869411,,110a214997f640cd96f474f3b2f72724,a759163a6e324c30a067be90b37241e7,,21/01/2023 8:20
31/01/2023 9:44,31,PLN,58,"10,68",PAY,RECEIVED,APPROVED,EUR,"0,88",EUR,647.88,,15031115,6928850765,,ddef8555fbef4216880589db84a4cfc5,a759163a6e324c30a067be90b37241e7,0.046,21/01/2023 8:16
31/01/2023 9:36,31,TRY,15,"-788,96",PAYOUT,SENT,APPROVED,EUR,"8,31",EUR,637.20,,15031096,6928839991,,5f2a18188f9649d4b0f9e969eeac9c4d,a759163a6e324c30a067be90b37241e7,,21/01/2023 8:16
31/01/2023 9:17,31,TRY,6,"267,47",PAY,RECEIVED,APPROVED,EUR,"9,51",EUR,1426.16,,15031070,6928818211,,64b76650f16743dcaded5536fe4675a3,a759163a6e324c30a067be90b37241e7,,21/01/2023 8:11
31/01/2023 8:57,31,EUR,10,"9,17",PAY,RECEIVED,APPROVED,EUR,"0,83",EUR,1158.69,,15030821,6928627275,,2f69869838af4eee859c693d6bf79815,a759163a6e324c30a067be90b37241e7,,21/01/2023 7:31
31/01/2023 7:36,31,TRY,22,"-115,94",PAYOUT,SENT,APPROVED,EUR,"1,65",EUR,1149.52,,15030789,6928600513,,0391bf9c802247d5be17d6901d0aefee,a759163a6e324c30a067be90b37241e7,0.046,21/01/2023 7:24
31/01/2023 7:02,31,EUR,10,"9,17",PAY,RECEIVED,APPROVED,EUR,"0,83",EUR,1265.46,,15030719,6928562795,,e5b7af9e0004442b9372116143375d0c,a759163a6e324c30a067be90b37241e7,,21/01/2023 7:16
31/01/2023 6:13,31,PLN,50,"9,14",PAY,RECEIVED,APPROVED,EUR,"0,83",EUR,1256.29,,15030678,6928535295,,6ba7874a2e3f40e7b1e7885821ec36df,a759163a6e324c30a067be90b37241e7,,21/01/2023 7:10
31/01/2023 6:09,31,PLN,15,"2,39",PAY,RECEIVED,APPROVED,EUR,"0,6",EUR,1247.15,,15030586,6928472591,,fd92602ee58e4b12b205886dab4e8d86,a759163a6e324c30a067be90b37241e7,,21/01/2023 6:52
31/01/2023 6:04,31,PLN,51,"9,33",PAY,RECEIVED,APPROVED,EUR,"0,84",EUR,1244.76,,2061020,1376828729,Payout description,ab6e64696d1644e88c4d0b1ab2ffe379,a759163a6e324c30a067be90b37241e7,0.052,21/01/2023 6:51
31/01/2023 5:53,31,PLN,13,2,PAY,RECEIVED,APPROVED,EUR,"0,59",EUR,1235.43,,15030552,6928447869,,451c607e0179413ca489ffe2181f9bf5,a759163a6e324c30a067be90b37241e7,0.046,21/01/2023 6:46
31/01/2023 3:21,31,EUR,20,"-20,7",PAYOUT,SENT,APPROVED,EUR,"0,7",EUR,1233.43,,15030473,6928389015,,d1d7dd29790b41c6bee0c33acd2aa850,a759163a6e324c30a067be90b37241e7,0.046,21/01/2023 6:29
31/01/2023 1:53,31,PLN,25,"4,31",PAY,RECEIVED,APPROVED,EUR,"0,67",EUR,1254.13,,15030385,6928330337,,14c161da8ce04b888dc5faf5db417bd4,a759163a6e324c30a067be90b37241e7,0.046,21/01/2023 6:11
31/01/2023 1:42,31,TRY,32,"0,92",PAY,RECEIVED,APPROVED,EUR,"0,55",EUR,1249.82,,2060935,1376757039,Payout description,dd3869cb8ed74c20bd35ef09e20f2d39,a759163a6e324c30a067be90b37241e7,0.052,21/01/2023 5:36
31/01/2023 0:47,31,TRY,1,"43,98",PAY,RECEIVED,APPROVED,EUR,2,EUR,1248.90,,15030100,6928131215,,5d2005734bf94886a886c4f0e1e1929d,a759163a6e324c30a067be90b37241e7,,21/01/2023 4:58
30/01/2023 23:21,30,EUR,10,"-10,6",PAYOUT,SENT,APPROVED,EUR,"0,6",EUR,1204.92,,15030065,6928107913,,c3dfc018366a4b489519cfa6907ab4d2,a759163a6e324c30a067be90b37241e7,,21/01/2023 4:47
30/01/2023 22:42,30,PLN,20,"3,35",PAY,RECEIVED,APPROVED,EUR,"0,63",EUR,1215.52,,15029949,6928036563,,ffaac257e71b404fb33128f51496e480,a759163a6e324c30a067be90b37241e7,0.046,21/01/2023 4:12
30/01/2023 22:38,30,PLN,20,"3,35",PAY,RECEIVED,APPROVED,EUR,"0,63",EUR,1212.17,,15029762,6927892743,,65465e2b0ca4467cba0009e3a8547ac2,a759163a6e324c30a067be90b37241e7,,21/01/2023 2:55
30/01/2023 22:36,30,EUR,"211,09","-213,71",PAYOUT,SENT,APPROVED,EUR,"2,62",EUR,1208.82,,15029756,6927890221,,2b4a228e8dd844d9bff2b78972c420a3,a759163a6e324c30a067be90b37241e7,0.209,21/01/2023 2:52
30/01/2023 22:36,30,TRY,1,"-52,98",PAYOUT,SENT,APPROVED,EUR,"1,02",EUR,1422.53,,2060765,1376653451,Payout description,c294fd82600d4926b2e37eafb3a2dc09,a759163a6e324c30a067be90b37241e7,0.052,21/01/2023 2:51
30/01/2023 22:32,30,PLN,30,"5,28",PAY,RECEIVED,APPROVED,EUR,"0,7",EUR,1475.51,,15029682,6927853199,,2528d562d4dc4927b3d29f70598568ee,a759163a6e324c30a067be90b37241e7,0.011,21/01/2023 2:30
30/01/2023 22:03,30,EUR,50,"47,87",PAY,RECEIVED,APPROVED,EUR,"2,13",EUR,1470.23,,15029538,6927781981,,6626bdd8a56f4d8198a1d521add681a1,a759163a6e324c30a067be90b37241e7,0.209,21/01/2023 1:48
30/01/2023 21:56,30,EUR,50,"47,87",PAY,RECEIVED,APPROVED,EUR,"2,13",EUR,1422.36,,15029515,6927771971,,0e62caec2a6e4aee989af01f02a7db39,a759163a6e324c30a067be90b37241e7,0.209,21/01/2023 1:43
30/01/2023 20:36,30,TRY,200,"-11,01",PAYOUT,SENT,APPROVED,EUR,"0,61",EUR,1374.49,,2060686,1376613861,Payout description,8c5e27686b3048719caa038c7c40e849,a759163a6e324c30a067be90b37241e7,0.052,21/01/2023 1:06
30/01/2023 20:14,30,TRY,24091,"1073,06",PAY,RECEIVED,APPROVED,EUR,"36,57",EUR,1385.50,,15029310,6927669705,,43628b0dae854624afebaa0b09545f10,a759163a6e324c30a067be90b37241e7,0.046,21/01/2023 0:53
30/01/2023 20:08,30,TRY,12,"52,97",PAY,RECEIVED,APPROVED,EUR,"2,3",EUR,312.44,,15029296,6927659353,,b630d1298b6b45a38a24f4b553948dc7,a759163a6e324c30a067be90b37241e7,0.046,21/01/2023 0:49
30/01/2023 19:53,30,PLN,91,"17,05",PAY,RECEIVED,APPROVED,EUR,"1,09",EUR,259.47,,15029020,6927534129,,4fa0dfe2beb84ecc87100316ef9a2bee,a759163a6e324c30a067be90b37241e7,,21/01/2023 0:05
30/01/2023 19:51,30,EUR,262,"-265,12",PAYOUT,SENT,APPROVED,EUR,"3,12",EUR,242.42,,2060560,1376561643,Payout description,a63b77294b9b40658bb46cfa459f44ba,a759163a6e324c30a067be90b37241e7,0.052,20/01/2023 23:36
30/01/2023 19:51,30,EUR,"156,08","-158,15",PAYOUT,SENT,APPROVED,EUR,"2,07",EUR,507.54,,2060522,1376543293,Payout description,dd0ceb767a9942fa926187e492203165,a759163a6e324c30a067be90b37241e7,0.052,20/01/2023 23:21
30/01/2023 19:50,30,TRY,10,"445,26",PAY,RECEIVED,APPROVED,EUR,"15,48",EUR,665.69,,15028723,6927372969,,09760b07378d499daeabee0e7652463d,a759163a6e324c30a067be90b37241e7,0.046,20/01/2023 23:18
30/01/2023 19:43,30,EUR,10,"9,17",PAY,RECEIVED,APPROVED,EUR,"0,83",EUR,220.43,,2060470,1376524727,Payout description,5fd20c44343f44018708030a0dd5bdd2,a759163a6e324c30a067be90b37241e7,,20/01/2023 23:06
30/01/2023 19:37,30,EUR,10,"9,17",PAY,RECEIVED,APPROVED,EUR,"0,83",EUR,211.26,,2060469,1376523553,Payout description,af96b76dc21d4fd6b119dc1cc01d3475,a759163a6e324c30a067be90b37241e7,0.052,20/01/2023 23:06
30/01/2023 19:24,30,PLN,105,"19,75",PAY,RECEIVED,APPROVED,EUR,"1,19",EUR,202.09,,15028557,6927290675,,bcc775120b7a43d6be95a60407092421,a759163a6e324c30a067be90b37241e7,,20/01/2023 22:57
30/01/2023 19:12,30,EUR,"3,9","3,27",PAY,RECEIVED,APPROVED,EUR,"0,63",EUR,182.34,,2060327,1376475151,Payout description,e1c06bb41cdf4d1eaa74744bc55f9e93,a759163a6e324c30a067be90b37241e7,0.052,20/01/2023 22:06
30/01/2023 18:55,30,EUR,"107,33","103,34",PAY,RECEIVED,APPROVED,EUR,"3,99",EUR,179.07,,2060322,1376468545,Payout description,1bf96ae103424e75b7d7fc98c3680b92,a759163a6e324c30a067be90b37241e7,0.052,20/01/2023 22:06
30/01/2023 18:44,30,EUR,50,"47,87",PAY,RECEIVED,APPROVED,EUR,"2,13",EUR,75.73,,15028058,6927043899,,37cb44c57a3b412bb45df04d9b3edfcf,a759163a6e324c30a067be90b37241e7,0.046,20/01/2023 22:05
30/01/2023 18:21,30,PLN,812,"-185,06",PAYOUT,SENT,APPROVED,EUR,"2,33",EUR,27.86,,15027924,6926981069,,045bc71136024dc49f3e7e24a5523e16,a759163a6e324c30a067be90b37241e7,0.046,20/01/2023 21:52
30/01/2023 18:06,30,EUR,"2336,19","-2360,06",PAYOUT,SENT,APPROVED,EUR,"23,87",EUR,212.92,,2060205,1376441683,Payout description,65aaad27247347d9939475a870e099bb,a759163a6e324c30a067be90b37241e7,0.052,20/01/2023 21:36
30/01/2023 17:58,30,PLN,503,"96,55",PAY,RECEIVED,APPROVED,EUR,"3,77",EUR,2572.98,,2060203,1376440381,Payout description,bb69e1b8a8d64f039ad77797acdbb5f2,a759163a6e324c30a067be90b37241e7,0.052,20/01/2023 21:36
30/01/2023 17:54,30,EUR,"657,6","635,72",PAY,RECEIVED,APPROVED,EUR,"21,88",EUR,2476.43,,15027590,6926808985,,95c2afc4e43749398b5a3db469fb64dc,a759163a6e324c30a067be90b37241e7,0.046,20/01/2023 21:22
30/01/2023 17:47,30,EUR,"10,11","9,28",PAY,RECEIVED,APPROVED,EUR,"0,83",EUR,1840.71,,15027571,6926800579,,eb34a9705d874a9e8ec17a36de3c9c9b,a759163a6e324c30a067be90b37241e7,,20/01/2023 21:21
30/01/2023 17:32,30,PLN,200,"38,09",PAY,RECEIVED,APPROVED,EUR,"1,8",EUR,1831.43,,2060161,1376426913,Payout description,41211426feec4ad687a600144ba246d0,a759163a6e324c30a067be90b37241e7,,20/01/2023 21:21
30/01/2023 17:25,30,TRY,880,"38,65",PAY,RECEIVED,APPROVED,EUR,"1,82",EUR,1793.34,,2060124,1376400469,Payout description,39f873386a874f92adc4770f09cb6b0d,a759163a6e324c30a067be90b37241e7,0.052,20/01/2023 21:06
30/01/2023 17:25,30,PLN,101,"18,99",PAY,RECEIVED,APPROVED,EUR,"1,16",EUR,1754.69,,15027220,6926607539,,b97a816fa9064cc2b77f03ecd7427433,a759163a6e324c30a067be90b37241e7,,20/01/2023 20:49
30/01/2023 17:21,30,INR,5,"-60,99",PAYOUT,SENT,APPROVED,EUR,"1,1",EUR,1735.70,,15026941,6926453859,,6e894fc4cc5c412f8dcb505064862954,a759163a6e324c30a067be90b37241e7,0.046,20/01/2023 20:25
30/01/2023 17:20,30,EUR,2,"1,43",PAY,RECEIVED,APPROVED,EUR,"0,57",EUR,1796.69,,15026893,6926430635,,2b55bcb13cf7443781c4678fb9c276dd,a759163a6e324c30a067be90b37241e7,,20/01/2023 20:21
30/01/2023 17:19,30,PLN,50,"9,14",PAY,RECEIVED,APPROVED,EUR,"0,83",EUR,1795.26,,15026654,6926297917,,cd4e87ca6b6a4dfa84b549b288919f37,a759163a6e324c30a067be90b37241e7,,20/01/2023 20:01
30/01/2023 17:00,30,EUR,20,"18,85",PAY,RECEIVED,APPROVED,EUR,"1,15",EUR,1786.12,,15026489,6926211355,,5a1e0d738a0e4665bc884525bcab36d8,a759163a6e324c30a067be90b37241e7,0.046,20/01/2023 19:48
30/01/2023 17:00,30,PLN,"51,4","9,41",PAY,RECEIVED,APPROVED,EUR,"0,84",EUR,1767.27,,15026179,6926041159,,9f79dfd8b0de4cf0ae1424a4d0a95a57,a759163a6e324c30a067be90b37241e7,0.046,20/01/2023 19:26
30/01/2023 16:41,30,TRY,400,"17,28",PAY,RECEIVED,APPROVED,EUR,"1,1",EUR,1757.86,,15025946,6925923563,,d5812d35c5634987975465e466dba361,a759163a6e324c30a067be90b37241e7,,20/01/2023 19:11
30/01/2023 16:21,30,EUR,10,"9,17",PAY,RECEIVED,APPROVED,EUR,"0,83",EUR,1740.58,,2059751,1376281107,Payout description,2b5a81af6b6d4686a2e7daa11903023f,a759163a6e324c30a067be90b37241e7,0.052,20/01/2023 19:06
30/01/2023 16:21,30,EUR,20,"-20,7",PAYOUT,SENT,APPROVED,EUR,"0,7",EUR,1731.41,,15025670,6925759825,,da15e1b5988544c981b64fdcb78f8060,a759163a6e324c30a067be90b37241e7,0.046,20/01/2023 18:51
30/01/2023 15:34,30,PLN,84,"15,7",PAY,RECEIVED,APPROVED,EUR,"1,05",EUR,1752.11,,15025603,6925708427,,c2cd5eb7c758450e958296fa98d0d5dc,a759163a6e324c30a067be90b37241e7,0.046,20/01/2023 18:44
30/01/2023 15:21,30,PLN,612,"-139,62",PAYOUT,SENT,APPROVED,EUR,"1,88",EUR,1736.41,,15025550,6925677711,,29f9f44d15c94156b1155ccb4e7debfc,a759163a6e324c30a067be90b37241e7,0.046,20/01/2023 18:40
30/01/2023 15:15,30,TRY,250,"10,58",PAY,RECEIVED,APPROVED,EUR,"0,88",EUR,1876.03,,15025523,6925653063,,452017a6d6564913b022d67c1193345a,a759163a6e324c30a067be90b37241e7,0.046,20/01/2023 18:37
30/01/2023 14:36,30,TRY,10,"-522,99",PAYOUT,SENT,APPROVED,EUR,"5,68",EUR,1865.45,,2059668,1376250221,Payout description,fbce21dff6874f3d8b3cb1c0c598f6e2,a759163a6e324c30a067be90b37241e7,,20/01/2023 18:36
30/01/2023 13:53,30,PLN,303,"57,99",PAY,RECEIVED,APPROVED,EUR,"2,47",EUR,2388.44,,15025320,6925536225,,d0aff5a39e444c439d6bde2039ca2708,a759163a6e324c30a067be90b37241e7,,20/01/2023 18:23
30/01/2023 13:39,30,PLN,200,"38,1",PAY,RECEIVED,APPROVED,EUR,"1,8",EUR,2330.45,,15025163,6925434785,,82de0470c2a14e1e87d13d112562dbff,a759163a6e324c30a067be90b37241e7,0.046,20/01/2023 18:08
30/01/2023 13:24,30,PLN,151,"28,64",PAY,RECEIVED,APPROVED,EUR,"1,48",EUR,2292.35,,2059556,1376206267,Payout description,b6c734c06109455db389cf3af94b9416,a759163a6e324c30a067be90b37241e7,0.052,20/01/2023 17:51
30/01/2023 13:15,30,PLN,50,"9,14",PAY,RECEIVED,APPROVED,EUR,"0,83",EUR,2263.71,,15024893,6925285325,,2198d0542dc04edf9489112d57836f92,a759163a6e324c30a067be90b37241e7,,20/01/2023 17:50
30/01/2023 13:02,30,TRY,1422,"629,75",PAY,RECEIVED,APPROVED,EUR,"21,68",EUR,2254.57,,15024255,6924914619,,6ca1cc3369b044ba9313f58b57f9aa24,a759163a6e324c30a067be90b37241e7,,20/01/2023 16:58
30/01/2023 12:38,30,SEK,269,"21,22",PAY,RECEIVED,APPROVED,EUR,"1,23",EUR,1624.82,,15024168,6924869443,,c94b21ff828f4151a3c687561d5fafdc,a759163a6e324c30a067be90b37241e7,0.046,20/01/2023 16:52
30/01/2023 12:37,30,PLN,"51,2","9,37",PAY,RECEIVED,APPROVED,EUR,"0,84",EUR,1603.60,,15023911,6924722075,,6151381bf19a4c7c9214cd1a1b414fdd,a759163a6e324c30a067be90b37241e7,0.046,20/01/2023 16:32
30/01/2023 12:22,30,EUR,50,"47,87",PAY,RECEIVED,APPROVED,EUR,"2,13",EUR,1594.23,,15023876,6924698193,,49c9791b57b4461a835acc005d9d4b2d,a759163a6e324c30a067be90b37241e7,0.2,20/01/2023 16:31
30/01/2023 12:01,30,TRY,200,"8,36",PAY,RECEIVED,APPROVED,EUR,"0,8",EUR,1546.36,,2059308,1376075605,Payout description,b30ff9fc1be6412194c7337357eae970,a759163a6e324c30a067be90b37241e7,0.052,20/01/2023 16:06
30/01/2023 11:33,30,PLN,52,"9,53",PAY,RECEIVED,APPROVED,EUR,"0,84",EUR,1538.00,,15023561,6924495803,,6968b74c3b9c4748a4e21fa0b51a7316,a759163a6e324c30a067be90b37241e7,,20/01/2023 16:02
30/01/2023 11:21,30,TRY,13585,"-709,68",PAYOUT,SENT,APPROVED,EUR,"7,53",EUR,1528.47,,15023454,6924417435,,2302364b78cd49a1bd38c5867e0ab349,a759163a6e324c30a067be90b37241e7,,20/01/2023 15:50
30/01/2023 11:16,30,EUR,11,"10,14",PAY,RECEIVED,APPROVED,EUR,"0,86",EUR,2238.15,,15023398,6924382343,,93006091239949a7a27a616189bd952b,a759163a6e324c30a067be90b37241e7,,20/01/2023 15:47
30/01/2023 10:36,30,EUR,80,"-81,3",PAYOUT,SENT,APPROVED,EUR,"1,3",EUR,2228.01,,2059249,1376028137,Payout description,e5b6351d31f742679ea66c5079a94fe6,a759163a6e324c30a067be90b37241e7,0.052,20/01/2023 15:36
30/01/2023 10:02,30,TRY,2,"88,09",PAY,RECEIVED,APPROVED,EUR,"3,48",EUR,2309.31,,15023113,6924194983,,d1884f9899d3431498e641990d8a60b0,a759163a6e324c30a067be90b37241e7,,20/01/2023 15:20
30/01/2023 9:53,30,TRY,30,"0,82",PAY,RECEIVED,APPROVED,EUR,"0,55",EUR,2221.22,,15022753,6923920313,,e10e0e7aa2be4f858156f05967efe9d0,a759163a6e324c30a067be90b37241e7,,20/01/2023 14:42
30/01/2023 9:34,30,EUR,2,"1,43",PAY,RECEIVED,APPROVED,EUR,"0,57",EUR,2220.40,,15022591,6923813267,,2900356bb7604fcfa5432dbcda0c8c42,a759163a6e324c30a067be90b37241e7,,20/01/2023 14:28
30/01/2023 9:06,30,EUR,5,"-5,55",PAYOUT,SENT,APPROVED,EUR,"0,55",EUR,2218.97,,15022402,6923686301,,d10572a49d9947cf84745e929af998c7,a759163a6e324c30a067be90b37241e7,0.046,20/01/2023 14:07
30/01/2023 8:23,30,EUR,2,"1,43",PAY,RECEIVED,APPROVED,EUR,"0,57",EUR,2224.52,,15022330,6923637409,,04c35347fbd2431cb574e7cb6a729ee7,a759163a6e324c30a067be90b37241e7,,20/01/2023 14:01
30/01/2023 8:17,30,EUR,2,"1,43",PAY,RECEIVED,APPROVED,EUR,"0,57",EUR,2223.09,,2058972,1375890673,Payout description,e7395f59afda4c07b5ab9d2abd42c37f,a759163a6e324c30a067be90b37241e7,0.052,20/01/2023 13:51
30/01/2023 6:48,30,EUR,"5,06","4,39",PAY,RECEIVED,APPROVED,EUR,"0,67",EUR,2221.66,,15022107,6923477535,,b1e8b472e09248ce87737645152f65d0,a759163a6e324c30a067be90b37241e7,,20/01/2023 13:37
30/01/2023 6:46,30,EUR,500,"483,25",PAY,RECEIVED,APPROVED,EUR,"16,75",EUR,2217.27,,15022028,6923432587,,ca8a4f8bab87441694a6bf1121909c48,a759163a6e324c30a067be90b37241e7,,20/01/2023 13:30
30/01/2023 5:08,30,JPY,30,"193,25",PAY,RECEIVED,APPROVED,EUR,"7,01",EUR,1734.02,,15021939,6923378147,,78636d7598a441ee93b27233e8d6267c,a759163a6e324c30a067be90b37241e7,0.046,20/01/2023 13:22
30/01/2023 3:21,30,TRY,15,"-786,02",PAYOUT,SENT,APPROVED,EUR,"8,28",EUR,1540.77,,15021870,6923339315,,cc60a12ae8ab4f938e31ef8f43eb1fad,a759163a6e324c30a067be90b37241e7,0.046,20/01/2023 13:16
30/01/2023 1:06,30,EUR,"28,79","-29,58",PAYOUT,SENT,APPROVED,EUR,"0,79",EUR,2326.79,,15021856,6923324541,,6cb8aba520cc40efa0715e30ab7a5225,a759163a6e324c30a067be90b37241e7,,20/01/2023 13:14
30/01/2023 0:21,30,TRY,107,"-56,57",PAYOUT,SENT,APPROVED,EUR,"1,06",EUR,2356.37,,15021824,6923304663,,cf92d7b446224c80898661ed33305a52,a759163a6e324c30a067be90b37241e7,,20/01/2023 13:13
30/01/2023 0:08,30,EUR,15,"14,01",PAY,RECEIVED,APPROVED,EUR,"0,99",EUR,2412.94,,2058845,1375831413,Payout description,c791b3518f024f9aac549f5026062fa2,a759163a6e324c30a067be90b37241e7,,20/01/2023 13:06
29/01/2023 23:51,29,EUR,275,"-278,25",PAYOUT,SENT,APPROVED,EUR,"3,25",EUR,2398.93,,15021716,6923213123,,14ef6577012f4c46885967fef2b579ce,a759163a6e324c30a067be90b37241e7,0.046,20/01/2023 12:58
29/01/2023 23:19,29,TRY,20,"887,4",PAY,RECEIVED,APPROVED,EUR,"30,33",EUR,2677.18,,15021632,6923156549,,6fdca26a02c742aa878d1aaacd2bdc4a,a759163a6e324c30a067be90b37241e7,,20/01/2023 12:50
29/01/2023 21:51,29,TRY,800,"-42,47",PAYOUT,SENT,APPROVED,EUR,"0,92",EUR,1789.78,,15021630,6923155807,,366ddc5388ad4e94a905e22a30982ab1,a759163a6e324c30a067be90b37241e7,0.046,20/01/2023 12:49
29/01/2023 20:51,29,TRY,1545,"68,21",PAY,RECEIVED,APPROVED,EUR,"2,81",EUR,1832.25,,15021594,6923118107,,d5251acc23ac44cea8c2763d400df6c8,a759163a6e324c30a067be90b37241e7,0.046,20/01/2023 12:44
29/01/2023 20:47,29,EUR,"1,35","0,8",PAY,RECEIVED,APPROVED,EUR,"0,55",EUR,1764.04,,2058742,1375746699,Payout description,38b1a23879e04ffc85ee52b5fb22b596,a759163a6e324c30a067be90b37241e7,,20/01/2023 12:36
29/01/2023 20:36,29,TRY,38,"-1990,47",PAYOUT,SENT,APPROVED,EUR,"20,21",EUR,1763.24,,15021242,6922873765,,fc8a1658c3db484db66b9a4f5140e0ea,a759163a6e324c30a067be90b37241e7,0.046,20/01/2023 12:08
29/01/2023 20:02,29,INR,5,"50,77",PAY,RECEIVED,APPROVED,EUR,"2,23",EUR,3753.71,,2058680,1375725615,Payout description,ad282149353c428fac82a6927b226886,a759163a6e324c30a067be90b37241e7,,20/01/2023 12:06
29/01/2023 18:28,29,TRY,406,"17,55",PAY,RECEIVED,APPROVED,EUR,"1,11",EUR,3702.94,,15020793,6922501367,,84199ba8d9b64dee8e686859cf0157a7,a759163a6e324c30a067be90b37241e7,0.199,20/01/2023 11:11
29/01/2023 17:51,29,EUR,33,"31,42",PAY,RECEIVED,APPROVED,EUR,"1,58",EUR,3685.39,,2058470,1375633595,Payout description,a8e91e987a9840c7895a502ca6fb6c17,a759163a6e324c30a067be90b37241e7,0.052,20/01/2023 10:51
29/01/2023 17:21,29,EUR,267,"-270,17",PAYOUT,SENT,APPROVED,EUR,"3,17",EUR,3653.97,,2058400,1375594785,Payout description,37b2141df1c34ce086ff6384f2b0a0c0,a759163a6e324c30a067be90b37241e7,0.012,20/01/2023 10:21
29/01/2023 17:21,29,TRY,15251,"-799,16",PAYOUT,SENT,APPROVED,EUR,"8,41",EUR,3924.14,,15020248,6922111883,,b987275688ec40bfb12ff5590bcfb9c9,a759163a6e324c30a067be90b37241e7,0.046,20/01/2023 10:04
29/01/2023 17:06,29,TRY,6,"-314,72",PAYOUT,SENT,APPROVED,EUR,"3,62",EUR,4723.30,,2058307,1375557369,Payout description,d0d17d4ebf0d4c7ebcdf64c1023b0b80,a759163a6e324c30a067be90b37241e7,0.052,20/01/2023 9:51
29/01/2023 17:06,29,TRY,20,"-1047,85",PAYOUT,SENT,APPROVED,EUR,"10,87",EUR,5038.02,,15019944,6921925549,,fe8e882779a14f6c8f4dc5e8782ff6f8,a759163a6e324c30a067be90b37241e7,0.046,20/01/2023 9:31
29/01/2023 16:06,29,TRY,"1979,11","-104,15",PAYOUT,SENT,APPROVED,EUR,"1,53",EUR,6085.87,,2058080,1375451423,Payout description,2a5faf36cc4c4ccf99f754072d1ef8c5,a759163a6e324c30a067be90b37241e7,0.052,20/01/2023 8:06
29/01/2023 15:25,29,EUR,50,"47,87",PAY,RECEIVED,APPROVED,EUR,"2,13",EUR,6190.02,,15019244,6921408991,,915cc4d70c944355baa0e42f8b808ddf,a759163a6e324c30a067be90b37241e7,,20/01/2023 7:42
29/01/2023 15:06,29,EUR,205,"-207,55",PAYOUT,SENT,APPROVED,EUR,"2,55",EUR,6142.15,,15019058,6921266379,,71865c9e1b2e4983a5b04d684d4ebbc0,a759163a6e324c30a067be90b37241e7,0.046,20/01/2023 7:00
29/01/2023 14:53,29,TRY,50,"1,71",PAY,RECEIVED,APPROVED,EUR,"0,58",EUR,6349.70,,15018963,6921197897,,f8170a5e3b334dba9f9739a19b49c9e2,a759163a6e324c30a067be90b37241e7,,20/01/2023 6:38
29/01/2023 14:51,29,TRY,300,"-16,22",PAYOUT,SENT,APPROVED,EUR,"0,66",EUR,6347.99,,15018860,6921129707,,1b1478a64ed34ab9a2eebc9a11859269,a759163a6e324c30a067be90b37241e7,0.046,20/01/2023 6:14
29/01/2023 14:51,29,TRY,50,"-3,13",PAYOUT,SENT,APPROVED,EUR,"0,53",EUR,6364.21,,15018603,6920916307,,d3da1c336e6d4e0097de720576609c86,a759163a6e324c30a067be90b37241e7,0.046,20/01/2023 4:48
29/01/2023 14:26,29,TRY,2011,"88,94",PAY,RECEIVED,APPROVED,EUR,"3,51",EUR,6367.34,,15018493,6920847609,,632f63f4aec943bfbb6a8f536b7f4271,a759163a6e324c30a067be90b37241e7,,20/01/2023 4:14
29/01/2023 14:03,29,TRY,369,"15,9",PAY,RECEIVED,APPROVED,EUR,"1,06",EUR,6278.40,,15018424,6920805997,,c9089b77002943c3a821c374d529deaa,a759163a6e324c30a067be90b37241e7,0.046,20/01/2023 3:50
29/01/2023 13:51,29,TRY,20,"-1047,85",PAYOUT,SENT,APPROVED,EUR,"10,87",EUR,6262.50,,15018341,6920746927,,c5cfbad7a8ba4ce78da57a369c1c9a6f,a759163a6e324c30a067be90b37241e7,,20/01/2023 3:16
29/01/2023 13:44,29,EUR,400,"386,5",PAY,RECEIVED,APPROVED,EUR,"13,5",EUR,7310.35,,15018327,6920739739,,76c4ac54c6d24cccafe083164e04ec5c,a759163a6e324c30a067be90b37241e7,,20/01/2023 3:12
29/01/2023 13:38,29,TRY,2,"88,45",PAY,RECEIVED,APPROVED,EUR,"3,49",EUR,6923.85,,2057667,1375149253,Payout description,c0bd22f6c58d43cba4dd7a3949fd47be,a759163a6e324c30a067be90b37241e7,0.012,20/01/2023 2:21
29/01/2023 12:36,29,TRY,15,"-786,02",PAYOUT,SENT,APPROVED,EUR,"8,28",EUR,6835.40,,15018175,6920646263,,9da7aa1e227245b49dfede7ebb0d1889,a759163a6e324c30a067be90b37241e7,0.046,20/01/2023 2:11
29/01/2023 12:30,29,TRY,150,"6,16",PAY,RECEIVED,APPROVED,EUR,"0,73",EUR,7621.42,,15017781,6920424995,,da0fda2216784b52867b1763efe11193,a759163a6e324c30a067be90b37241e7,0.046,20/01/2023 0:21
29/01/2023 12:15,29,SEK,10,"810,49",PAY,RECEIVED,APPROVED,EUR,"27,75",EUR,7615.26,,2057508,1375070113,Payout description,07edfd7c1ef04750819fec65082bf921,a759163a6e324c30a067be90b37241e7,,20/01/2023 0:21
29/01/2023 12:06,29,TRY,"48,27","-3,04",PAYOUT,SENT,APPROVED,EUR,"0,53",EUR,6804.77,,15017651,6920358933,,0c9ab54b198d441daa25c3d8b3024f34,a759163a6e324c30a067be90b37241e7,0.046,19/01/2023 23:59
29/01/2023 12:06,29,EUR,39,"-39,89",PAYOUT,SENT,APPROVED,EUR,"0,89",EUR,6807.81,,15017551,6920308319,,1006d8b653cb403ea456ec8b7b4c9f46,a759163a6e324c30a067be90b37241e7,0.046,19/01/2023 23:42
29/01/2023 12:06,29,TRY,5,"-262,35",PAYOUT,SENT,APPROVED,EUR,"3,1",EUR,6847.70,,15017550,6920307863,,a5e8e3f39da2421c8773836213ca6a95,a759163a6e324c30a067be90b37241e7,0.199,19/01/2023 23:42
29/01/2023 11:51,29,TRY,188,"-10,35",PAYOUT,SENT,APPROVED,EUR,"0,6",EUR,7110.05,,15017520,6920291449,,4649157b832f4c548b08e9ff6311c302,a759163a6e324c30a067be90b37241e7,0.199,19/01/2023 23:36
29/01/2023 11:31,29,TRY,800,"35,07",PAY,RECEIVED,APPROVED,EUR,"1,7",EUR,7120.40,,15017458,6920266771,,10afaad325d9443c85c396192382e703,a759163a6e324c30a067be90b37241e7,0.046,19/01/2023 23:28
29/01/2023 11:23,29,TRY,302,"12,92",PAY,RECEIVED,APPROVED,EUR,"0,96",EUR,7085.33,,15017346,6920207597,,cdbc7d7b80a644438f43b58184ec1654,a759163a6e324c30a067be90b37241e7,,19/01/2023 23:09
29/01/2023 11:06,29,TRY,15,"-786,02",PAYOUT,SENT,APPROVED,EUR,"8,28",EUR,7072.41,,15017218,6920157521,,0228c2bb6bcc40b5bfde472677bd3021,a759163a6e324c30a067be90b37241e7,,19/01/2023 22:55
29/01/2023 10:55,29,TRY,50,"1,71",PAY,RECEIVED,APPROVED,EUR,"0,58",EUR,7858.43,,15017204,6920149829,,4e6e8cd7a6ab41ae9456779a9219ea08,a759163a6e324c30a067be90b37241e7,,19/01/2023 22:52
29/01/2023 10:42,29,TRY,25,"1111,44",PAY,RECEIVED,APPROVED,EUR,"37,86",EUR,7856.72,,15016974,6920044961,,3416c23dcc4a4150984e442e334ad18e,a759163a6e324c30a067be90b37241e7,0.046,19/01/2023 22:25
29/01/2023 10:21,29,TRY,880,"-46,59",PAYOUT,SENT,APPROVED,EUR,"0,96",EUR,6745.28,,15016914,6920011133,,92d37ded875147d3b998e355c4c4a6a5,a759163a6e324c30a067be90b37241e7,,19/01/2023 22:17
29/01/2023 10:19,29,TRY,100,"3,94",PAY,RECEIVED,APPROVED,EUR,"0,65",EUR,6791.87,,2056951,1374733537,Payout description,bb820d37de7643f9a74f92acdbbdbe6e,a759163a6e324c30a067be90b37241e7,,19/01/2023 21:51
29/01/2023 10:18,29,TRY,1145,"50,41",PAY,RECEIVED,APPROVED,EUR,"2,22",EUR,6787.93,,15016571,6919845591,,3dcccf6f2173432d9b650799e9a41bac,a759163a6e324c30a067be90b37241e7,,19/01/2023 21:38
29/01/2023 9:53,29,PLN,"25,52","4,42",PAY,RECEIVED,APPROVED,EUR,"0,67",EUR,6737.52,,2056878,1374728051,Payout description,d54947ff212446ad9afbd142b4f6e61b,a759163a6e324c30a067be90b37241e7,0.052,19/01/2023 21:36
29/01/2023 9:46,29,TRY,232,"9,81",PAY,RECEIVED,APPROVED,EUR,"0,85",EUR,6733.10,,15016518,6919820903,,832e0ad05dfc458f81111a5b89159f92,a759163a6e324c30a067be90b37241e7,,19/01/2023 21:33
29/01/2023 9:28,29,TRY,215,"9,05",PAY,RECEIVED,APPROVED,EUR,"0,83",EUR,6723.29,,15016345,6919743491,,091f7b0b6c6c4b3f951e3623c3572148,a759163a6e324c30a067be90b37241e7,,19/01/2023 21:17
29/01/2023 8:36,29,TRY,"420,8","-22,54",PAYOUT,SENT,APPROVED,EUR,"0,72",EUR,6714.24,,15016333,6919738807,,1739c66ea6d4484b8eb8c877d62f4a46,a759163a6e324c30a067be90b37241e7,,19/01/2023 21:16
29/01/2023 8:36,29,TRY,262,"-137,71",PAYOUT,SENT,APPROVED,EUR,"1,86",EUR,6736.78,,15016293,6919720937,,0dc884cecbde45268ee10f1fd6fe855c,a759163a6e324c30a067be90b37241e7,0.046,19/01/2023 21:13
29/01/2023 7:08,29,TRY,12,"52,86",PAY,RECEIVED,APPROVED,EUR,"2,3",EUR,6874.49,,15016294,6919720951,,f7444b26e59f4e2a9ac41588ef6f4e2a,a759163a6e324c30a067be90b37241e7,0.046,19/01/2023 21:13
29/01/2023 7:06,29,TRY,10,"-524,18",PAYOUT,SENT,APPROVED,EUR,"5,69",EUR,6821.63,,15016048,6919588007,,f7e9e2618eaa4aec81d6d11a7154982a,a759163a6e324c30a067be90b37241e7,0.046,19/01/2023 20:53
29/01/2023 6:54,29,TRY,98,"3,85",PAY,RECEIVED,APPROVED,EUR,"0,65",EUR,7345.81,,2056698,1374677889,Payout description,65d190e5defa49f6a23dea05cd84dccd,a759163a6e324c30a067be90b37241e7,0.052,19/01/2023 20:51
29/01/2023 6:21,29,SEK,"250,95","-24,52",PAYOUT,SENT,APPROVED,EUR,"0,74",EUR,7341.96,,15015917,6919516187,,f493421a190942ffad940c6967d2c65c,a759163a6e324c30a067be90b37241e7,,19/01/2023 20:42
29/01/2023 2:07,29,PLN,25,"4,31",PAY,RECEIVED,APPROVED,EUR,"0,67",EUR,7366.48,,2056593,1374649281,Payout description,3920b3d441df4cf8b35972f36268e9d8,a759163a6e324c30a067be90b37241e7,,19/01/2023 20:21
29/01/2023 0:47,29,TRY,5,"221,88",PAY,RECEIVED,APPROVED,EUR,"7,98",EUR,7362.17,,15015576,6919307353,,2d0912ff75e14ad4b6e1e41c264d726e,a759163a6e324c30a067be90b37241e7,,19/01/2023 20:08
29/01/2023 0:34,29,TRY,646,"28,22",PAY,RECEIVED,APPROVED,EUR,"1,47",EUR,7140.29,,15015407,6919188505,,42d10ffbdecf4b53ab51a40517991f9e,a759163a6e324c30a067be90b37241e7,,19/01/2023 19:52
29/01/2023 0:11,29,TRY,51,"226,33",PAY,RECEIVED,APPROVED,EUR,"8,12",EUR,7112.07,,2056488,1374613367,Payout description,66465f467efd47a3b27d56569c64ddac,a759163a6e324c30a067be90b37241e7,,19/01/2023 19:51